20 34 34 34 34 34 34 34 34 34 34 34 21 26 26 20 34 34 34 34 34 34 34 34 34 34 34 34 34 34 34 34 34 34 34 34 34 34 34 21 
27 1 1 1 1 5 1 105 106 107 1 5 25 36 26 27 5 5 3 5 3 1 1 1 1 1 1 1 1 5 3 3 5 5 5 2 2 1 1 25 
27 1 105 106 107 1 1 121 122 123 1 1 25 36 26 27 2 5 5 1 1 1 5 2 3 3 4 2 3 3 5 3 5 3 3 3 3 1 5 25 
27 1 121 122 123 142 142 137 138 139 1 17 29 26 26 27 5 5 4 1 2 4 3 3 5 2 5 5 3 4 1 1 1 1 1 1 5 1 1 25 
27 1 137 138 139 142 142 142 142 1 1 25 26 26 26 27 2 1 1 1 5 4 3 4 5 3 5 5 4 4 1 4 4 2 5 5 5 2 1 25 
27 1 1 1 1 1 142 142 142 1 1 25 26 36 36 27 5 1 2 5 5 3 4 2 5 1 1 1 1 1 1 5 5 5 5 3 5 2 1 25 
27 1 5 1 1 97 98 98 98 98 99 25 26 36 20 35 1 1 5 2 5 2 2 4 3 1 5 3 5 5 2 2 3 5 3 2 1 1 1 25 
27 1 108 109 1 113 93 95 93 95 115 25 36 26 27 2 1 1 1 1 1 1 1 1 1 1 5 4 3 5 4 3 4 5 3 4 1 2 2 25 
27 1 124 125 1 113 93 95 93 95 115 25 26 26 27 3 1 5 3 5 3 3 3 3 5 5 3 2 4 5 2 3 3 5 2 4 1 4 2 25 
27 5 1 1 1 129 130 130 130 130 131 25 26 26 27 5 1 4 2 3 3 2 5 3 4 5 5 5 5 4 2 5 4 4 4 2 1 4 5 25 
28 18 18 18 18 18 18 18 18 18 18 29 20 34 35 1 1 5 4 2 4 5 5 4 5 5 3 3 2 4 3 5 3 3 5 2 1 5 3 25 
20 34 34 34 34 34 34 34 34 34 34 34 35 5 3 1 2 5 3 4 4 5 5 5 5 3 5 3 5 3 5 2 3 5 1 1 1 5 4 25 
27 4 2 5 2 4 5 1 1 1 1 1 4 5 5 1 3 5 4 5 5 2 5 3 2 2 3 2 2 4 4 2 3 1 1 5 4 3 5 25 
27 3 4 2 4 3 3 1 3 4 2 1 5 4 2 1 3 5 5 3 2 4 4 4 5 4 3 5 3 3 5 3 5 1 3 2 2 5 2 25 
27 5 5 4 2 3 5 1 1 1 1 1 1 1 1 1 5 4 5 4 2 4 97 98 98 98 98 99 2 3 3 4 5 1 2 3 2 3 4 25 
27 2 4 5 2 3 4 5 3 2 3 1 5 4 5 2 2 4 5 5 4 4 113 102 103 104 4 115 3 4 3 4 2 1 2 2 2 3 3 25 
27 4 2 5 5 5 4 5 2 2 5 1 3 5 2 5 2 3 2 3 3 2 113 118 119 120 3 115 4 5 3 3 5 1 5 4 3 4 3 25 
27 2 2 3 3 2 3 3 4 5 5 1 1 1 3 2 5 4 5 2 3 4 113 134 135 136 3 115 2 3 2 5 5 1 1 2 4 4 4 25 
27 3 4 5 4 3 5 2 2 1 1 1 1 1 5 5 2 3 3 2 5 2 113 110 3 4 3 115 3 4 2 2 2 2 1 3 5 4 4 25 
27 5 2 5 3 5 5 5 4 1 3 3 3 5 3 2 2 2 2 5 2 2 129 132 89 3 114 131 4 3 3 2 3 4 1 3 2 5 3 25 
27 4 4 5 3 3 1 1 1 1 5 2 2 5 3 4 2 5 5 4 4 2 3 3 5 3 2 2 5 4 4 2 5 2 1 4 2 5 5 25 
27 5 3 5 4 5 1 5 4 5 3 5 3 4 5 5 4 4 5 2 4 4 4 3 5 2 5 3 5 2 3 5 5 2 1 4 4 5 4 25 
27 2 4 3 4 3 1 5 2 3 2 2 2 4 4 2 2 2 5 3 2 2 2 2 2 4 3 4 4 5 5 2 3 3 1 1 1 1 2 25 
27 5 2 5 4 5 1 4 5 2 5 3 2 5 5 2 5 5 2 5 4 3 2 2 4 3 2 5 4 5 3 5 4 2 4 3 5 1 4 25 
27 4 2 5 5 3 1 4 5 2 5 2 3 5 3 2 2 4 4 5 4 2 5 5 3 4 4 3 5 5 5 1 1 1 1 1 1 1 5 25 
27 3 2 4 4 3 1 4 4 4 3 2 3 2 4 5 4 2 4 5 5 3 4 4 2 5 5 5 4 2 3 1 3 3 5 5 4 3 4 25 
27 3 3 5 5 4 1 2 4 4 3 4 5 2 4 4 2 5 5 3 2 4 2 5 4 5 5 1 1 1 1 1 5 2 5 2 3 2 5 25 
27 5 2 5 4 5 1 5 5 3 2 4 2 3 2 4 3 4 2 3 2 3 2 5 5 5 2 1 3 2 4 2 5 5 17 18 18 18 18 29 
27 3 4 4 4 5 1 1 2 3 4 3 2 3 4 5 2 4 3 5 2 2 2 3 3 5 4 1 2 17 18 18 18 18 29 26 26 26 26 26 
27 2 2 2 4 5 5 1 2 4 5 4 5 3 5 2 5 3 2 1 1 1 1 1 1 5 4 1 17 29 26 20 34 34 34 34 34 34 34 21 
27 3 3 2 2 4 5 1 2 3 5 2 5 4 4 3 2 3 3 1 5 4 3 2 1 1 1 1 25 26 36 27 89 1 1 1 1 1 1 25 
27 3 5 5 2 4 2 1 4 5 1 1 1 1 1 1 1 1 1 1 5 5 3 3 2 3 17 18 29 26 36 27 1 1 102 103 104 1 90 25 
27 5 2 3 2 3 5 1 5 4 1 5 2 5 4 2 5 2 3 2 2 4 4 3 5 2 25 26 26 36 36 27 1 1 118 119 120 1 1 25 
27 1 1 1 1 1 1 1 1 1 1 5 2 4 5 2 2 5 2 4 5 4 4 5 3 5 25 26 20 34 34 35 1 1 134 135 136 1 1 25 
27 1 4 2 5 3 5 1 5 3 4 3 5 2 4 5 4 4 5 3 2 2 4 5 3 3 25 36 27 1 1 1 1 1 1 1 1 1 101 25 
27 1 5 3 3 2 5 1 4 3 5 3 3 5 3 5 3 3 5 3 5 3 17 18 18 18 29 36 27 1 91 96 91 96 91 1 1 1 1 25 
27 1 1 1 1 1 1 1 2 2 5 4 3 4 4 5 4 2 4 5 2 5 25 26 20 34 34 34 35 1 91 93 91 93 91 1 108 109 1 25 
27 1 1 4 3 2 5 5 3 3 5 2 3 4 2 4 4 3 4 3 3 2 25 26 27 1 101 92 1 1 91 93 91 93 91 92 124 125 1 25 
27 1 1 5 5 2 5 2 2 4 3 4 5 5 5 5 3 2 4 3 5 4 25 26 27 89 1 92 1 1 91 95 91 95 91 92 1 1 1 25 
28 18 18 18 18 18 18 18 18 18 18 18 18 18 18 18 18 18 18 18 18 18 29 26 28 18 18 18 18 18 18 18 18 18 18 18 18 18 18 29