20 34 34 34 34 34 34 34 34 34 34 34 34 34 34 34 34 21 26 26 26 26 26 26 26 26 20 34 34 34 34 34 34 34 34 34 34 34 34 21
27 5 3 2 4 4 5 2 4 3 4 5 2 2 1 1 1 25 26 26 26 26 26 26 26 26 27 4 4 4 5 5 2 4 4 3 3 2 2 25
27 3 2 4 5 3 3 3 3 5 3 1 1 1 1 5 2 25 26 26 26 26 26 26 26 26 27 4 3 2 5 2 4 3 3 5 3 3 5 25
27 2 4 5 5 5 2 2 4 3 2 1 2 5 4 5 2 33 26 26 26 26 26 26 26 26 27 2 5 3 3 102 103 104 102 103 104 5 4 25
27 4 2 4 2 4 3 5 5 4 5 1 3 3 5 5 3 3 33 34 34 34 21 26 26 26 27 3 4 4 4 118 119 120 118 119 120 5 3 25
27 4 3 4 3 5 2 4 4 4 3 1 4 5 4 5 3 2 5 5 2 5 25 26 26 26 28 19 2 4 3 134 135 136 134 135 136 5 5 25
27 4 3 5 2 1 1 1 1 1 1 1 5 5 2 37 17 18 18 19 4 5 25 26 26 26 26 27 3 2 3 102 103 104 102 103 104 3 5 25
27 5 2 3 4 1 3 4 3 3 3 1 5 2 2 5 25 36 26 27 5 2 33 34 34 34 34 35 3 2 3 118 119 120 118 119 120 2 4 25
27 5 2 4 3 1 5 2 5 4 5 1 3 3 4 89 25 36 26 27 1 1 1 1 4 4 2 2 3 3 2 134 135 136 134 135 136 3 2 25
27 4 4 4 5 1 1 5 5 5 4 1 3 2 3 5 33 34 34 35 1 3 2 1 4 5 3 3 5 3 5 5 3 2 5 4 5 5 5 25
27 5 5 5 1 1 1 3 2 3 5 1 1 1 1 1 1 1 1 1 1 4 4 1 5 3 3 3 2 5 2 4 3 90 90 90 90 90 90 25
27 4 5 3 1 4 2 5 5 2 5 3 4 5 4 2 2 5 4 4 5 4 3 1 2 5 3 3 2 2 4 5 3 90 95 95 95 96 90 25
27 4 1 1 1 5 3 3 4 4 3 4 5 5 4 2 5 3 5 3 4 4 5 1 1 1 5 2 2 4 2 2 2 90 95 95 95 96 90 25
27 5 1 4 3 4 2 5 5 4 4 3 2 97 98 98 98 99 2 5 2 3 5 3 5 1 1 4 4 3 4 5 5 90 95 96 95 96 90 25
27 1 1 5 2 3 5 5 4 4 5 3 3 113 102 103 104 115 3 5 3 4 2 4 2 5 1 4 2 4 3 4 3 90 90 90 90 90 90 25
27 1 1 1 1 1 1 2 5 5 5 2 5 113 118 119 120 115 4 5 5 5 4 5 5 4 1 4 5 4 5 2 2 5 2 5 4 4 2 25
27 3 5 3 4 4 1 3 5 5 2 5 3 113 134 135 136 115 2 3 5 3 5 2 105 106 1 1 1 1 1 1 1 1 2 4 2 4 3 25
27 2 5 2 4 2 1 3 5 4 4 5 3 129 132 2 114 131 3 5 2 3 2 4 121 122 123 2 3 4 4 2 3 1 3 4 4 5 5 25
28 18 18 18 19 5 1 2 2 4 3 2 2 4 3 3 4 4 5 3 3 5 4 4 137 138 139 2 3 2 2 3 5 1 1 1 1 1 1 25
26 26 26 26 27 5 5 3 3 2 3 5 4 2 2 5 3 2 5 4 2 3 5 5 105 106 107 3 3 2 4 5 3 5 5 2 2 5 1 25
26 36 36 26 27 5 1 4 3 4 3 3 2 2 4 3 3 2 4 5 5 3 2 5 121 122 123 3 4 4 5 4 4 2 4 3 2 2 1 25
26 26 36 36 27 2 1 3 5 5 3 2 4 2 2 4 2 4 3 4 3 3 4 2 137 138 139 5 5 5 2 2 5 3 3 4 3 4 1 25
26 36 26 26 27 5 1 3 5 3 3 4 3 5 3 5 5 4 3 2 4 4 5 5 4 2 2 4 5 4 2 3 1 1 1 1 1 1 1 25
36 36 26 26 27 3 1 5 3 4 2 2 2 5 4 3 2 3 5 3 4 5 4 5 2 5 2 4 3 5 5 5 1 4 5 5 2 3 2 25
26 20 34 34 35 2 1 5 3 4 4 4 5 4 2 3 4 4 1 1 1 1 5 5 4 5 4 2 2 3 2 5 1 1 1 4 5 5 2 25
26 27 3 3 4 4 1 2 3 5 4 2 3 4 2 5 5 3 1 2 5 1 3 1 1 1 1 1 1 1 1 5 2 5 1 5 2 5 5 25
26 27 4 4 3 5 1 2 2 5 5 3 2 4 4 4 4 4 1 4 2 1 4 1 3 4 3 5 4 5 1 2 4 2 1 4 5 2 2 25
26 27 2 5 2 5 1 4 4 4 5 3 2 4 3 4 5 4 1 2 3 1 1 1 5 4 3 4 4 5 1 1 1 1 1 1 5 3 4 25
20 35 5 2 5 1 1 5 3 4 3 4 4 4 4 2 5 3 1 4 3 5 3 5 5 3 3 4 2 4 5 5 5 4 1 1 5 5 4 25
27 2 3 4 3 1 3 5 4 4 2 4 2 3 3 4 5 5 1 5 4 3 5 5 2 3 3 4 2 4 3 2 3 5 1 1 3 3 4 25
27 5 3 3 4 1 3 3 5 5 2 4 2 3 3 4 5 1 1 5 2 5 5 3 3 2 5 2 4 3 4 4 3 2 3 5 4 4 2 25
27 3 3 3 2 1 4 4 4 4 3 3 2 3 5 5 4 1 4 3 3 2 4 3 2 3 2 2 2 4 3 4 3 2 2 3 5 2 2 25
27 5 4 2 3 1 5 5 5 4 5 4 2 5 5 5 4 1 3 5 2 4 3 2 4 2 5 4 4 4 89 97 98 98 98 98 99 4 4 25
27 1 1 1 1 1 5 1 1 1 1 1 1 1 1 1 1 1 5 17 18 18 18 18 18 18 18 18 18 19 5 113 91 91 91 95 115 5 5 25
27 1 3 5 3 2 2 1 4 5 4 5 3 5 5 4 4 3 5 25 36 26 26 26 26 26 26 26 26 27 3 113 91 93 95 93 115 4 5 25
27 1 5 1 1 1 1 1 5 2 3 3 105 106 107 3 3 4 2 25 26 36 20 34 34 21 26 26 26 27 3 113 92 93 96 93 115 5 5 25
27 1 1 1 5 4 5 2 2 4 3 4 121 122 123 2 5 2 2 25 26 20 35 108 109 25 26 36 36 27 5 129 130 130 130 130 131 2 3 25
27 5 1 5 3 4 4 3 5 3 3 4 137 138 139 5 2 4 4 25 26 27 1 124 125 25 26 36 36 27 2 4 3 3 5 4 2 4 2 25
27 1 1 5 5 2 2 3 4 3 4 2 2 3 5 5 5 4 2 25 26 28 18 18 18 29 36 36 36 28 18 18 18 18 18 18 19 3 2 25
28 18 18 18 18 18 18 18 18 18 18 18 18 18 18 18 18 18 18 29 26 26 26 26 26 26 36 36 26 26 26 26 26 26 26 26 28 18 18 29