26 26 26 36 36 36 36 36 26 26 26 26 26 26 26 26 26 26 26 26 26 26 26 26 26 26 26 26 26 26 26 26 26 26 26 26 26 26 26 26
26 26 26 36 36 36 36 36 36 36 36 36 26 26 26 26 26 26 36 36 36 36 36 36 36 36 36 36 36 26 26 26 26 26 26 26 26 26 26 26
26 26 26 26 36 36 36 36 36 36 26 36 26 26 26 36 36 36 36 26 26 26 26 26 26 26 26 26 26 26 26 36 36 36 36 26 26 26 26 26
26 26 26 36 36 36 36 36 36 26 26 26 26 26 26 26 26 26 26 26 26 26 26 26 26 26 26 26 26 26 26 26 26 26 26 26 26 26 26 26
26 26 26 26 36 34 34 34 34 34 34 34 34 34 34 34 34 34 34 34 34 34 34 34 34 26 26 34 34 34 34 34 34 34 34 34 26 26 26 26
26 26 26 26 27 2 2 2 2 2 2 2 2 2 2 2 2 2 2 2 2 2 2 2 2 25 27 2 2 2 2 2 2 2 2 2 25 26 26 26
26 26 26 26 27 2 2 2 2 2 2 2 2 2 2 2 2 2 2 2 2 2 2 2 2 25 27 2 2 2 2 2 2 2 2 2 25 26 26 26
26 26 26 26 27 2 2 2 2 2 2 2 2 2 2 2 2 2 2 2 2 2 2 2 2 25 27 2 2 2 2 2 2 2 2 2 25 26 26 26
26 26 26 26 27 2 2 2 105 106 107 2 2 2 2 2 2 2 2 2 2 2 2 2 2 25 27 2 2 2 2 2 2 2 2 2 25 26 26 26
26 26 26 26 27 2 108 109 121 122 123 2 2 2 2 2 2 2 2 5 2 2 2 2 2 25 27 2 2 2 2 2 2 2 2 2 25 26 26 26
26 26 26 26 27 113 124 125 137 138 139 100 2 2 2 17 19 2 2 5 2 2 2 2 2 33 36 19 2 2 2 2 2 2 2 2 25 26 26 26
26 26 26 26 27 113 31 31 31 31 31 115 2 2 2 33 35 2 2 2 2 2 2 2 2 2 25 27 2 2 2 2 2 2 2 2 25 26 26 26
26 26 26 26 27 113 31 31 31 31 31 115 2 2 2 2 2 2 2 2 2 2 2 2 2 2 25 27 2 2 2 2 2 2 2 2 25 26 26 26
26 26 26 26 27 129 130 130 2 130 130 131 2 2 2 2 2 2 2 2 2 2 2 2 2 2 25 27 2 2 2 2 2 2 2 2 25 26 26 26
26 26 26 26 27 2 105 2 2 2 2 2 2 2 2 2 2 2 2 2 2 2 2 2 2 17 26 27 2 2 2 2 2 2 2 2 25 26 26 26
26 26 26 26 27 2 2 2 2 2 2 2 2 2 2 2 2 2 5 5 2 2 2 2 2 25 26 27 2 2 2 2 2 2 2 2 25 26 26 26
26 26 26 26 27 2 2 2 2 2 2 2 2 2 2 2 2 2 2 2 2 2 2 2 2 33 34 35 5 17 18 18 18 18 18 18 26 26 26 26
26 26 26 26 27 2 2 2 2 2 2 2 2 2 17 19 2 2 2 2 2 2 2 2 2 2 2 2 2 33 34 34 34 34 34 34 26 26 26 26
26 26 26 26 26 18 18 18 18 19 2 2 2 2 33 35 2 2 2 2 2 5 2 2 2 2 2 2 2 2 2 2 2 2 2 2 25 26 26 26
26 26 26 26 26 34 34 34 34 35 2 2 2 2 2 2 2 2 2 2 2 5 5 5 2 2 2 2 2 2 2 2 2 2 2 2 25 26 26 36
26 36 36 26 27 2 2 2 2 2 2 2 2 2 2 2 2 2 2 2 5 5 5 5 2 2 2 5 2 2 2 2 2 2 2 2 25 26 26 36
26 36 26 26 27 2 2 2 2 2 2 2 2 2 2 5 5 2 2 2 2 2 2 2 2 2 2 2 2 5 2 2 2 2 2 2 25 26 26 36
26 36 26 26 27 5 2 5 5 2 5 2 2 2 2 5 5 2 2 2 2 91 3 2 2 5 2 2 2 5 5 2 5 2 2 2 25 26 26 36
26 36 26 26 27 2 2 2 2 2 5 5 2 2 2 2 5 2 3 3 3 3 2 2 5 5 2 2 2 2 2 2 5 2 2 2 25 26 26 36
26 36 26 26 27 2 2 2 2 2 5 5 2 2 2 2 2 2 2 2 2 2 2 2 2 2 2 17 19 2 2 2 5 2 2 2 25 26 26 36
26 36 26 26 27 2 2 2 2 2 2 2 2 2 2 2 2 2 2 2 2 2 2 2 2 2 17 26 35 2 2 2 2 2 2 2 25 26 36 36
26 36 26 26 27 2 2 2 2 2 2 2 2 17 18 18 18 19 2 2 2 2 5 2 2 2 25 27 2 2 2 2 2 2 2 2 25 26 36 26
26 36 26 26 27 2 2 2 2 2 2 2 2 33 34 34 34 35 2 2 2 2 2 2 2 2 25 27 2 2 2 5 5 5 2 2 25 26 26 26
26 36 26 26 27 102 103 104 2 2 2 2 2 2 2 2 2 2 2 2 2 5 2 2 2 2 25 27 2 2 5 2 2 2 2 2 25 26 26 26
26 26 26 26 27 118 119 120 2 108 109 2 2 2 2 2 2 2 2 2 2 2 2 2 2 2 33 35 2 2 2 2 2 2 2 2 25 26 26 26
26 26 26 26 27 134 135 136 2 124 125 2 2 2 2 2 2 2 2 2 2 2 2 2 2 2 2 2 2 2 2 2 2 2 2 2 25 26 26 26
26 26 26 26 27 31 31 31 31 31 31 2 2 2 2 17 19 2 2 2 2 2 2 2 2 2 2 2 2 2 2 2 2 2 2 2 25 26 26 26
26 26 26 26 27 31 78 31 31 31 31 2 2 2 2 33 20 18 18 19 2 2 2 2 2 2 2 5 5 5 2 2 2 2 2 2 25 26 26 26
26 26 26 26 27 31 31 31 78 31 31 2 2 2 2 2 33 34 34 35 5 5 2 2 2 2 2 2 2 2 2 2 2 2 2 2 25 26 26 26
26 26 26 26 27 31 31 31 31 31 31 2 2 2 2 2 2 2 2 2 5 5 2 2 2 2 2 2 2 2 2 2 2 2 2 2 25 26 26 26
26 26 26 26 27 31 31 31 31 31 79 2 2 2 2 2 2 2 2 2 5 5 2 2 2 2 2 2 2 2 2 2 2 2 2 37 25 26 26 26
26 26 26 36 36 18 18 18 18 18 18 18 18 18 18 18 18 18 18 18 18 18 18 18 18 18 18 18 18 18 18 18 18 18 18 18 26 26 26 26
26 26 26 26 26 26 26 26 26 26 26 26 26 26 26 26 26 26 26 26 26 26 26 26 36 36 36 26 26 26 26 26 26 26 26 26 26 26 26 26
26 26 26 26 26 26 26 26 26 26 26 26 26 26 26 26 26 26 26 26 36 36 36 36 36 36 26 26 26 26 26 26 26 26 26 26 26 26 26 26
26 26 26 26 26 26 26 26 26 26 26 26 26 26 26 26 26 26 26 26 26 26 26 26 26 26 26 26 26 26 26 26 26 26 26 26 26 26 26 26