74 74 74 74 74 74 74 74 74 74 74 74 74 74 74 74 74 74 74 74 74 74 74 74 74 74 74 74 74 74 74 74 74 74 74 74 74 74 74 74 
74 74 74 74 74 74 74 74 74 74 74 74 74 74 74 74 74 74 74 74 74 74 74 74 74 74 74 74 74 74 74 74 74 74 74 74 74 74 74 74 
74 74 74 74 74 74 74 74 74 74 74 74 74 74 74 74 74 74 74 74 74 74 74 74 74 74 74 74 74 74 74 74 74 74 74 74 74 74 74 74 
74 74 74 74 74 74 74 74 74 74 74 74 74 74 74 74 74 74 74 74 74 74 74 74 74 74 74 74 74 74 74 74 74 74 74 74 74 74 74 74 
74 74 74 74 74 74 74 74 74 74 74 74 74 74 74 74 74 74 74 74 74 74 74 74 74 74 74 74 74 74 74 74 74 74 74 74 74 74 74 74 
74 74 74 74 74 74 74 74 74 74 74 74 74 74 74 74 74 74 74 74 74 74 74 74 74 74 74 74 74 74 74 74 74 74 74 74 74 74 74 74 
74 74 74 74 74 74 74 74 74 74 74 74 74 74 74 74 74 74 74 74 74 74 74 74 74 74 74 74 74 74 74 74 74 74 74 74 74 74 74 74 
74 74 74 74 74 74 74 74 74 74 74 74 74 74 74 74 74 74 74 74 74 74 74 74 74 74 74 74 74 74 74 74 74 74 74 74 74 74 74 74 
74 74 74 74 74 74 74 74 74 74 74 74 74 74 74 74 74 74 74 74 74 74 74 74 74 74 74 74 74 74 74 74 74 74 74 74 74 74 74 74 
74 74 74 74 74 74 74 74 74 76 82 82 82 82 82 82 82 82 82 82 82 82 82 82 82 82 82 82 82 82 77 74 74 74 74 74 74 74 74 74 
74 74 74 74 74 74 74 74 74 75 80 70 70 70 70 70 70 70 70 78 70 70 71 80 86 70 70 70 70 70 73 74 74 74 74 74 74 74 74 74 
74 74 74 74 74 74 74 74 74 75 72 70 70 70 70 79 70 70 72 79 70 70 70 72 70 80 79 70 79 70 73 74 74 74 74 74 74 74 74 74 
74 74 74 74 74 74 74 74 74 75 70 70 71 70 71 70 71 70 70 70 71 70 70 70 70 70 71 70 79 71 73 74 74 74 74 74 74 74 74 74 
74 74 74 74 74 74 74 74 74 75 80 70 70 70 70 70 70 70 70 70 70 87 79 70 70 79 80 70 72 70 73 74 74 74 74 74 74 74 74 74 
74 74 74 74 74 74 74 74 74 75 71 79 70 70 70 79 70 71 80 70 70 80 70 70 70 70 80 70 70 70 73 74 74 74 74 74 74 74 74 74 
74 74 74 74 74 74 74 74 74 75 70 72 70 70 70 80 79 78 70 70 70 70 70 70 71 70 70 72 71 70 73 74 74 74 74 74 74 74 74 74 
74 74 74 74 74 74 74 74 74 75 72 70 70 70 70 78 70 70 71 70 70 70 70 71 72 70 70 70 70 70 73 74 74 74 74 74 74 74 74 74 
74 74 74 74 74 74 74 74 74 75 79 70 72 70 70 70 70 70 70 78 70 70 70 70 70 72 70 72 78 70 73 74 74 74 74 74 74 74 74 74 
74 74 74 74 74 74 74 74 74 75 70 70 79 72 72 70 71 78 70 78 72 70 70 70 70 71 70 78 70 70 73 74 74 74 74 74 74 74 74 74 
74 74 74 74 74 74 74 74 74 75 70 70 70 70 70 70 70 78 70 72 71 80 70 70 70 70 70 70 70 79 73 74 74 74 74 74 74 74 74 74 
74 74 74 74 74 74 74 74 74 75 72 79 72 70 70 70 70 70 70 80 72 70 70 70 70 78 70 79 70 70 73 74 74 74 74 74 74 74 74 74 
74 74 74 74 74 74 74 74 74 75 72 70 71 70 70 70 70 70 70 70 70 72 70 70 70 71 70 72 79 70 73 74 74 74 74 74 74 74 74 74 
74 74 74 74 74 74 74 74 74 75 70 70 70 70 70 70 70 79 70 70 70 70 70 79 72 78 70 79 70 70 73 74 74 74 74 74 74 74 74 74 
74 74 74 74 74 74 74 74 74 75 70 80 80 70 70 70 72 70 72 70 80 70 70 70 70 70 70 70 80 70 73 74 74 74 74 74 74 74 74 74 
74 74 74 74 74 74 74 74 74 75 70 71 71 79 72 70 70 70 70 72 70 70 70 78 70 70 70 70 71 70 73 74 74 74 74 74 74 74 74 74 
74 74 74 74 74 74 74 74 74 75 70 70 70 70 72 70 80 71 70 71 80 70 70 70 70 70 70 79 70 70 73 74 74 74 74 74 74 74 74 74 
74 74 74 74 74 74 74 74 74 75 70 79 79 70 70 72 70 70 78 71 70 70 70 70 70 78 70 79 70 78 73 74 74 74 74 74 74 74 74 74 
74 74 74 74 74 74 74 74 74 75 70 78 70 80 70 80 80 78 70 70 70 70 70 70 70 70 70 70 70 79 73 74 74 74 74 74 74 74 74 74 
74 74 74 74 74 74 74 74 74 75 70 79 70 72 70 70 70 70 72 70 70 70 70 70 78 70 79 70 70 71 73 74 74 74 74 74 74 74 74 74
74 74 74 74 74 74 74 74 74 75 70 70 70 70 70 70 70 70 70 70 70 70 70 70 70 70 70 70 70 70 73 74 74 74 74 74 74 74 74 74
74 74 74 74 74 74 74 74 74 84 66 66 66 66 66 66 66 66 66 66 66 66 66 66 66 66 66 66 66 66 85 74 74 74 74 74 74 74 74 74 
74 74 74 74 74 74 74 74 74 74 74 74 74 74 74 74 74 74 74 74 74 74 74 74 74 74 74 74 74 74 74 74 74 74 74 74 74 74 74 74 
74 74 74 74 74 74 74 74 74 74 74 74 74 74 74 74 74 74 74 74 74 74 74 74 74 74 74 74 74 74 74 74 74 74 74 74 74 74 74 74 
74 74 74 74 74 74 74 74 74 74 74 74 74 74 74 74 74 74 74 74 74 74 74 74 74 74 74 74 74 74 74 74 74 74 74 74 74 74 74 74 
74 74 74 74 74 74 74 74 74 74 74 74 74 74 74 74 74 74 74 74 74 74 74 74 74 74 74 74 74 74 74 74 74 74 74 74 74 74 74 74 
74 74 74 74 74 74 74 74 74 74 74 74 74 74 74 74 74 74 74 74 74 74 74 74 74 74 74 74 74 74 74 74 74 74 74 74 74 74 74 74 
74 74 74 74 74 74 74 74 74 74 74 74 74 74 74 74 74 74 74 74 74 74 74 74 74 74 74 74 74 74 74 74 74 74 74 74 74 74 74 74 
74 74 74 74 74 74 74 74 74 74 74 74 74 74 74 74 74 74 74 74 74 74 74 74 74 74 74 74 74 74 74 74 74 74 74 74 74 74 74 74 
74 74 74 74 74 74 74 74 74 74 74 74 74 74 74 74 74 74 74 74 74 74 74 74 74 74 74 74 74 74 74 74 74 74 74 74 74 74 74 74 
74 74 74 74 74 74 74 74 74 74 74 74 74 74 74 74 74 74 74 74 74 74 74 74 74 74 74 74 74 74 74 74 74 74 74 74 74 74 74 74