20 34 34 34 34 34 34 34 34 34 34 34 34 34 34 34 34 34 34 34 34 34 34 34 34 34 34 34 34 34 34 34 34 34 34 34 34 34 34 21 
27 4 1 2 1 3 5 1 3 1 3 2 5 3 1 3 4 2 1 3 2 2 2 3 5 1 1 1 1 1 1 1 1 5 1 1 1 1 1 25 
27 2 4 2 4 2 1 5 2 2 4 5 1 5 2 4 5 4 1 5 5 4 5 5 3 1 4 2 5 2 2 3 1 1 1 5 5 3 1 25 
27 3 1 5 1 5 4 2 5 4 4 4 3 3 2 5 3 3 4 4 1 1 1 1 1 1 5 5 2 5 4 1 1 1 1 2 5 1 1 25 
27 1 3 4 1 2 2 5 4 3 1 4 1 4 2 3 5 4 5 3 1 3 3 4 5 1 3 1 5 4 4 1 1 1 4 4 1 5 1 25 
27 3 3 2 3 4 1 4 5 1 1 5 3 3 5 3 1 4 2 2 1 2 2 3 3 1 3 1 3 5 3 2 1 1 5 3 5 4 1 25 
27 5 3 5 5 1 4 1 2 3 4 2 2 5 3 1 3 4 1 5 1 5 1 1 4 3 1 3 1 5 2 3 1 1 1 5 2 2 1 25 
27 1 5 4 3 5 4 1 5 3 5 5 3 2 4 1 3 5 2 1 1 5 4 4 1 1 4 2 3 5 4 2 1 1 1 1 1 1 1 25 
27 1 4 1 17 18 18 19 2 2 3 1 2 5 2 1 2 5 2 1 5 4 5 5 4 3 3 5 3 3 5 3 5 1 2 5 1 2 5 25 
27 1 1 5 25 26 26 28 18 18 19 4 2 5 4 2 3 1 5 1 1 2 4 3 3 2 3 4 1 5 2 5 5 1 4 1 5 3 1 25 
27 1 3 2 25 26 26 26 26 26 27 2 3 5 2 2 4 2 5 1 2 5 2 4 4 5 1 5 4 5 1 1 1 1 1 2 5 3 1 25 
27 1 3 5 25 26 26 26 26 26 27 17 18 19 4 3 5 4 4 1 4 3 1 4 5 4 1 2 5 5 1 5 5 4 4 2 3 5 1 25 
27 1 5 4 33 34 34 34 21 26 28 29 26 27 5 5 3 5 3 1 1 4 2 5 2 5 5 4 1 1 1 5 2 5 2 3 3 5 1 25 
27 1 2 4 5 2 1 4 33 21 26 26 26 27 1 4 5 2 3 1 1 1 3 1 1 1 1 1 1 1 1 4 3 1 5 5 4 1 1 25 
27 1 1 1 1 2 1 5 3 33 34 34 34 35 2 2 4 1 3 1 4 4 1 1 4 17 18 18 18 18 18 18 19 5 4 5 5 1 5 25 
27 5 1 4 1 5 1 1 3 5 3 4 5 5 1 1 4 5 5 1 4 5 3 1 5 25 26 26 26 26 26 26 27 5 4 1 1 1 5 25 
27 1 1 4 1 4 2 3 1 5 3 3 1 1 1 1 5 3 2 1 4 3 5 1 2 25 26 26 26 26 26 26 27 2 2 1 1 4 2 25 
27 4 2 2 1 4 5 3 3 5 5 3 1 1 4 1 1 5 1 1 1 5 4 1 2 25 26 26 26 26 26 26 27 2 3 1 5 3 4 25 
27 5 5 4 1 5 5 3 2 3 1 1 1 5 5 5 1 4 2 1 5 3 4 1 5 33 34 21 26 26 26 26 27 4 4 1 1 2 3 25 
27 3 1 5 1 1 1 5 1 2 1 2 3 5 5 4 1 3 3 1 1 2 5 1 1 1 4 33 21 26 26 26 27 4 4 1 5 2 5 25 
27 1 2 2 1 1 5 1 1 1 1 5 3 3 5 4 1 1 1 1 5 5 2 1 2 3 2 2 33 21 26 26 27 3 4 1 3 5 3 25 
27 3 4 3 5 5 2 1 4 1 5 1 2 2 4 2 5 5 2 4 1 1 1 1 2 1 1 4 3 33 21 26 27 2 4 1 2 5 4 25 
27 1 5 2 1 1 1 1 5 5 5 5 1 2 1 5 3 1 2 1 5 1 5 2 3 4 5 4 5 2 33 34 35 5 4 1 4 5 5 25 
27 3 3 4 1 4 5 2 5 1 4 1 2 5 1 5 4 1 1 1 1 1 3 4 1 5 1 2 1 3 1 5 1 1 1 1 5 4 2 25 
27 3 2 1 1 5 1 4 2 4 5 4 1 1 2 4 4 1 3 5 2 3 1 5 4 2 5 2 5 3 5 1 1 1 5 4 3 4 3 25 
27 5 5 1 1 1 4 2 5 4 3 3 4 1 2 5 5 1 5 4 4 5 4 1 1 1 1 1 1 1 1 1 5 2 1 5 2 3 5 25 
27 1 1 1 1 5 4 3 1 2 4 1 2 5 2 1 3 1 5 3 3 2 4 1 3 2 5 5 4 3 2 5 3 3 4 2 5 1 5 25 
27 1 5 4 3 1 3 1 2 5 2 17 18 19 3 4 2 1 3 2 4 1 2 1 1 97 98 98 98 98 98 98 98 98 99 5 5 3 2 25 
27 1 4 2 1 17 18 18 18 18 18 29 26 28 18 19 1 1 2 2 4 3 2 1 5 113 1 1 1 1 1 1 1 1 115 1 4 3 2 25 
27 1 1 2 4 25 26 26 26 26 26 26 26 26 26 27 1 1 4 5 1 4 4 1 4 113 1 102 103 104 1 1 1 1 115 1 5 1 5 25 
27 1 5 2 1 25 26 26 20 34 21 26 26 26 26 27 1 1 4 4 4 4 3 1 3 113 1 118 119 120 1 1 108 109 115 1 3 5 4 25 
27 1 1 5 4 25 26 26 27 37 25 26 26 26 26 27 2 1 5 3 4 2 1 1 5 113 1 134 135 136 1 1 124 125 115 3 2 3 2 25 
27 1 1 2 5 25 26 26 28 18 29 26 26 26 26 27 5 1 1 1 1 1 1 1 1 113 1 1 1 1 1 1 1 1 115 4 1 3 1 25 
27 1 5 1 4 25 26 26 26 26 26 26 34 34 34 35 1 3 1 3 2 3 2 5 5 113 1 1 1 1 1 1 1 1 115 2 2 2 1 25 
27 1 1 3 3 33 21 26 20 34 21 27 3 5 5 2 2 5 1 4 2 3 2 1 2 129 130 130 130 130 130 130 131 1 116 1 2 1 5 25 
27 2 1 5 4 4 33 34 35 1 25 27 1 5 1 2 1 4 1 5 4 5 4 4 5 1 5 1 4 3 3 5 1 1 1 5 5 5 1 25 
27 1 1 4 3 1 5 5 3 3 33 35 2 4 1 1 1 1 1 1 5 5 2 4 4 5 4 2 1 2 5 5 1 1 1 5 5 1 1 25 
27 4 1 1 5 5 3 2 2 1 1 1 1 1 1 5 4 4 1 4 2 2 2 5 1 1 4 4 1 3 5 5 1 1 1 5 1 1 1 25 
27 5 1 1 1 1 1 1 1 1 5 1 1 4 3 5 4 2 4 3 5 3 3 1 2 3 2 5 2 2 5 1 1 1 1 1 1 1 1 25 
28 18 18 18 18 18 18 18 18 18 18 18 18 18 18 18 18 18 18 18 18 18 18 18 18 18 18 18 18 18 18 18 18 18 18 18 18 18 18 29