26 26 26 26 26 26 26 26 26 26 26 26 26 26 26 26 26 26 26 26 26 26 26 26 26 26 26 26 26 26 26 26 26 26 26 26 26 26 26 26 
26 26 26 26 26 26 26 26 26 26 26 26 26 26 26 26 26 26 26 26 26 26 26 26 26 26 26 26 26 26 26 26 26 26 26 26 26 26 26 26 
26 26 26 26 26 26 26 26 26 26 26 26 26 26 26 26 26 26 26 26 26 26 26 26 26 26 26 26 26 26 26 26 26 26 26 26 26 26 26 26 
26 26 26 26 26 26 26 26 26 26 26 26 26 26 26 26 26 26 26 26 26 26 26 26 26 26 26 26 26 26 26 26 26 26 26 26 26 26 26 26 
26 26 26 26 26 26 26 26 26 26 26 26 26 26 26 26 26 26 26 26 26 26 26 26 26 26 26 26 26 26 26 26 26 26 26 26 26 26 26 26 
26 26 26 26 26 26 26 26 26 26 26 26 26 26 26 26 26 26 26 26 26 26 26 26 26 26 26 26 26 26 26 26 26 26 26 26 26 26 26 26 
26 26 26 26 26 26 26 26 26 26 26 26 26 26 26 26 26 26 26 26 26 26 26 26 26 26 26 26 26 26 26 26 26 26 26 26 26 26 26 26 
26 26 26 26 26 26 26 26 26 26 26 26 26 26 26 26 26 26 26 26 26 26 26 26 26 26 26 26 26 26 26 26 26 26 26 26 26 26 26 26 
26 26 26 26 26 26 26 26 26 26 26 26 26 26 26 26 26 26 26 26 26 26 26 26 26 26 26 26 26 26 26 26 26 26 26 26 26 26 26 26 
26 26 26 26 26 26 26 26 26 20 34 34 34 34 34 34 34 34 34 34 34 34 34 34 34 34 34 34 34 34 21 26 26 26 26 26 26 26 26 26 
26 26 26 26 26 26 26 26 26 27 12 9 13 1 9 9 1 13 2 4 13 12 12 12 12 12 12 12 12 37 25 26 26 26 26 26 26 26 26 26 
26 26 26 26 26 26 26 26 26 27 12 3 12 12 12 12 12 12 13 2 1 12 11 1 13 10 12 2 12 11 25 26 26 26 26 26 26 26 26 26 
26 26 26 26 26 26 26 26 26 27 10 1 12 1 9 3 3 12 9 4 9 12 9 13 12 12 12 12 12 13 25 26 26 26 26 26 26 26 26 26 
26 26 26 26 26 26 26 26 26 27 4 1 12 3 4 13 13 12 12 12 12 12 13 10 12 13 11 1 13 3 25 26 26 26 26 26 26 26 26 26 
26 26 26 26 26 26 26 26 26 27 2 13 12 12 12 12 13 13 12 2 9 12 3 4 12 11 1 11 3 4 25 26 26 26 26 26 26 26 26 26 
26 26 26 26 26 26 26 26 26 27 1 4 13 9 12 12 3 12 13 2 13 12 12 12 12 13 3 12 4 2 25 26 26 26 26 26 26 26 26 26 
26 26 26 26 26 26 26 26 26 27 10 2 3 10 13 12 12 12 12 13 13 13 1 12 13 10 10 4 1 13 25 26 26 26 26 26 26 26 26 26 
26 26 26 26 26 26 26 26 26 27 4 3 2 1 2 13 2 12 12 13 12 12 12 12 12 12 12 12 12 12 25 26 26 26 26 26 26 26 26 26 
26 26 26 26 26 26 26 26 26 27 2 13 1 1 9 13 12 1 12 11 12 10 10 4 12 10 10 11 11 12 25 26 26 26 26 26 26 26 26 26 
26 26 26 26 26 26 26 26 26 27 13 12 12 12 12 12 13 13 12 12 12 13 2 1 12 3 10 10 13 12 25 26 26 26 26 26 26 26 26 26 
26 26 26 26 26 26 26 26 26 27 2 12 4 3 4 12 4 1 13 9 13 1 13 10 12 9 9 13 12 12 25 26 26 26 26 26 26 26 26 26 
26 26 26 26 26 26 26 26 26 27 9 12 9 9 13 12 12 3 12 12 12 12 12 13 12 4 12 9 12 13 25 26 26 26 26 26 26 26 26 26 
26 26 26 26 26 26 26 26 26 27 13 12 12 12 11 13 12 12 12 13 12 2 12 2 12 9 11 3 12 12 25 26 26 26 26 26 26 26 26 26 
26 26 26 26 26 26 26 26 26 27 11 13 12 12 9 3 13 3 13 10 10 13 12 12 12 13 13 11 12 11 25 26 26 26 26 26 26 26 26 26 
26 26 26 26 26 26 26 26 26 27 13 12 12 12 12 12 12 13 10 2 4 12 13 13 13 13 12 12 12 13 25 26 26 26 26 26 26 26 26 26 
26 26 26 26 26 26 26 26 26 27 12 12 4 12 13 10 12 12 9 1 4 1 13 12 12 12 12 13 13 3 25 26 26 26 26 26 26 26 26 26 
26 26 26 26 26 26 26 26 26 27 11 12 13 12 12 13 12 12 13 9 10 3 10 12 13 10 13 4 3 12 25 26 26 26 26 26 26 26 26 26 
26 26 26 26 26 26 26 26 26 27 2 12 12 13 12 13 12 12 12 13 10 13 13 12 12 12 12 13 1 12 25 26 26 26 26 26 26 26 26 26 
26 26 26 26 26 26 26 26 26 27 13 12 12 12 12 13 13 11 12 12 12 12 13 13 4 11 12 12 1 11 25 26 26 26 26 26 26 26 26 26 
26 26 26 26 26 26 26 26 26 27 3 13 11 11 13 9 3 13 12 12 12 12 12 12 12 12 12 1 12 9 25 26 26 26 26 26 26 26 26 26 
26 26 26 26 26 26 26 26 26 28 18 18 18 18 18 18 18 18 18 18 18 18 18 18 18 18 18 18 18 18 29 26 26 26 26 26 26 26 26 26 
26 26 26 26 26 26 26 26 26 26 26 26 26 26 26 26 26 26 26 26 26 26 26 26 26 26 26 26 26 26 26 26 26 26 26 26 26 26 26 26 
26 26 26 26 26 26 26 26 26 26 26 26 26 26 26 26 26 26 26 26 26 26 26 26 26 26 26 26 26 26 26 26 26 26 26 26 26 26 26 26 
26 26 26 26 26 26 26 26 26 26 26 26 26 26 26 26 26 26 26 26 26 26 26 26 26 26 26 26 26 26 26 26 26 26 26 26 26 26 26 26 
26 26 26 26 26 26 26 26 26 26 26 26 26 26 26 26 26 26 26 26 26 26 26 26 26 26 26 26 26 26 26 26 26 26 26 26 26 26 26 26 
26 26 26 26 26 26 26 26 26 26 26 26 26 26 26 26 26 26 26 26 26 26 26 26 26 26 26 26 26 26 26 26 26 26 26 26 26 26 26 26 
26 26 26 26 26 26 26 26 26 26 26 26 26 26 26 26 26 26 26 26 26 26 26 26 26 26 26 26 26 26 26 26 26 26 26 26 26 26 26 26 
26 26 26 26 26 26 26 26 26 26 26 26 26 26 26 26 26 26 26 26 26 26 26 26 26 26 26 26 26 26 26 26 26 26 26 26 26 26 26 26 
26 26 26 26 26 26 26 26 26 26 26 26 26 26 26 26 26 26 26 26 26 26 26 26 26 26 26 26 26 26 26 26 26 26 26 26 26 26 26 26 
26 26 26 26 26 26 26 26 26 26 26 26 26 26 26 26 26 26 26 26 26 26 26 26 26 26 26 26 26 26 26 26 26 26 26 26 26 26 26 26