60 58 58 58 58 58 58 58 58 59 81 82 82 82 82 82 82 82 82 82 82 82 82 82 82 82 82 82 82 83 57 58 58 58 58 58 58 58 58 61 
51 70 71 78 72 70 70 71 70 72 88 70 72 70 87 87 70 70 70 87 70 70 88 72 71 86 88 71 86 86 70 70 70 70 70 70 70 70 70 49 
51 70 88 70 70 70 70 70 70 70 70 70 70 70 70 70 70 70 70 70 70 70 70 70 70 70 70 72 70 70 70 70 70 72 70 70 87 88 70 49 
51 70 72 70 72 71 87 86 88 72 88 70 70 70 70 87 70 70 72 72 72 70 70 70 70 70 70 86 86 87 70 86 70 70 86 70 72 70 70 49 
51 87 87 70 70 72 70 65 66 67 70 72 88 88 70 70 71 70 88 72 72 70 71 88 87 70 70 86 70 72 70 65 66 67 71 72 79 87 70 49 
51 70 87 70 72 88 70 73 74 75 86 70 71 72 70 70 72 71 72 70 70 70 71 70 87 72 70 70 70 70 70 73 74 75 88 72 70 70 70 49 
51 88 70 70 72 87 86 81 82 83 71 86 71 87 70 86 70 70 70 87 70 70 70 71 70 72 88 88 87 70 87 81 82 83 70 70 70 70 88 49 
51 72 87 70 70 70 70 70 70 70 70 70 70 70 70 78 70 70 70 87 70 70 70 70 70 70 70 70 70 70 70 80 70 70 87 70 70 70 70 49 
51 70 88 71 70 70 70 70 70 70 88 86 71 71 70 70 72 70 70 87 70 71 87 70 70 70 70 70 70 72 70 70 86 88 70 87 70 70 72 49 
51 72 70 87 88 70 86 70 88 72 70 86 70 88 72 70 70 70 72 87 86 71 72 70 70 70 70 70 88 70 70 46 47 48 87 88 70 86 87 57 
59 71 70 70 46 47 48 70 88 70 70 70 72 88 71 70 71 71 86 88 70 70 70 71 71 70 71 70 70 88 70 62 63 64 70 72 70 71 70 65 
67 87 70 71 62 63 64 70 71 70 70 70 70 70 70 70 70 70 70 70 70 70 70 70 70 70 70 70 80 70 70 72 88 86 72 70 70 70 71 73 
75 70 86 88 86 70 88 70 86 70 70 22 23 23 23 23 23 23 23 23 23 23 23 23 23 23 23 24 70 86 70 70 70 70 70 70 70 80 72 73 
75 70 86 88 70 70 72 70 72 70 70 30 105 106 107 105 106 107 93 93 93 102 103 104 102 103 104 32 70 72 72 70 70 88 87 71 86 70 70 73 
75 70 70 87 70 70 87 70 86 70 70 30 121 122 123 121 122 123 93 93 94 118 119 120 118 119 120 32 86 87 72 88 70 70 71 70 70 70 70 73 
75 71 71 70 70 70 70 70 88 70 70 30 137 138 139 137 138 139 94 94 94 134 135 136 134 135 136 32 88 87 86 70 88 87 70 72 70 70 88 73 
75 88 86 87 41 42 43 70 71 70 70 38 39 39 39 39 39 39 39 39 39 39 39 39 39 39 39 40 70 70 70 88 65 66 67 87 88 70 72 73 
75 71 70 80 57 58 59 70 70 70 70 70 70 70 70 70 70 70 70 70 70 70 70 70 70 70 70 70 70 70 70 70 81 82 83 71 86 72 70 73 
75 87 87 70 70 70 70 70 70 70 86 71 72 70 88 70 70 72 70 88 86 71 88 70 87 70 72 87 70 86 86 70 70 70 71 70 70 86 71 73 
75 70 88 70 87 71 86 70 71 70 71 70 86 88 88 70 70 70 88 71 70 86 72 70 86 87 71 86 87 70 87 70 86 70 70 70 70 70 86 81 
75 70 71 70 70 71 71 72 70 72 88 22 23 23 23 23 23 23 23 23 23 23 23 23 23 23 23 24 86 70 86 70 86 70 86 87 86 71 87 65 
75 86 70 70 70 70 70 71 71 70 70 30 17 18 19 17 18 19 126 126 126 108 109 108 109 94 126 32 72 70 70 70 70 72 70 71 70 71 87 73 
75 86 71 70 70 70 70 70 70 86 70 30 25 26 27 25 26 27 127 127 112 124 125 124 125 110 94 32 70 70 87 70 70 71 86 70 70 70 72 73 
75 70 87 70 72 70 70 70 70 70 70 30 25 26 27 25 26 27 144 143 127 108 109 108 109 126 94 32 87 71 71 70 71 70 87 72 70 70 87 73 
75 70 71 70 70 88 70 86 70 70 70 30 33 34 35 33 34 35 111 112 110 124 125 124 125 126 126 32 87 71 87 70 87 86 46 47 48 70 88 73 
75 70 70 70 46 47 48 87 70 72 70 38 39 39 39 39 39 39 39 39 39 39 39 39 39 39 39 40 71 70 78 70 70 70 62 63 64 72 70 73 
83 71 70 70 62 63 64 71 70 70 70 70 70 87 70 70 88 86 88 70 72 86 72 70 71 70 70 88 71 72 70 70 87 70 70 70 70 70 70 73 
67 86 70 70 71 70 72 70 88 70 70 88 70 71 86 70 70 86 88 86 70 70 71 70 88 70 70 70 78 72 88 72 70 87 71 70 70 70 72 73 
75 88 70 70 70 87 70 72 70 86 70 70 71 71 70 72 70 71 71 87 86 70 70 88 70 86 71 70 70 70 70 70 70 70 70 70 70 87 71 73 
75 70 70 70 72 72 86 71 88 70 70 70 72 87 70 88 86 70 72 70 70 88 71 88 87 71 70 70 70 86 88 70 70 72 70 70 70 87 71 81 
51 70 70 71 71 88 41 42 43 71 70 70 72 65 66 66 66 66 66 66 66 66 67 86 88 71 71 70 70 70 41 42 43 70 72 70 70 87 88 41 
51 70 70 87 72 70 49 50 51 71 70 70 87 73 76 77 76 77 76 77 76 77 75 87 70 86 70 71 70 87 49 50 51 87 86 70 70 70 70 49 
51 70 87 70 70 70 57 58 59 88 70 70 88 73 84 85 84 85 84 85 84 85 75 70 70 71 71 71 70 86 57 58 59 70 88 70 70 70 88 49 
51 70 87 70 70 70 71 70 87 70 70 87 70 81 82 82 82 82 82 82 82 82 83 88 87 71 70 72 70 70 70 88 70 70 70 70 70 70 70 49 
51 70 86 71 88 70 70 71 70 70 70 79 71 70 86 70 70 71 70 88 88 70 70 70 70 70 70 70 70 88 71 70 71 87 72 70 70 70 70 49 
51 70 71 87 71 70 70 70 70 79 70 70 70 70 70 70 70 79 70 72 70 70 71 70 70 70 70 87 70 70 70 70 70 70 70 70 70 86 70 49 
51 70 70 87 71 70 87 88 70 86 87 70 70 70 70 87 70 70 70 70 86 72 87 70 87 86 88 86 70 70 86 88 70 70 70 88 70 88 70 49 
51 70 88 70 71 70 86 70 70 70 72 86 70 72 70 70 70 70 70 70 70 70 70 70 78 70 70 72 70 70 72 71 70 72 86 71 70 70 70 49 
51 70 70 70 70 70 71 88 70 86 86 70 70 87 72 71 79 70 72 70 86 70 87 70 70 70 70 88 70 70 88 70 72 88 70 71 70 71 70 49 
68 42 42 42 42 42 42 42 42 43 65 66 66 66 66 66 66 66 66 66 66 66 66 66 66 66 66 66 66 67 41 42 42 42 42 42 42 42 42 69