26 26 26 36 36 36 36 36 36 26 36 26 36 36 26 26 26 20 34 34 34 34 34 34 34 34 34 34 34 34 34 34 34 34 34 34 34 34 34 21
36 26 26 26 26 36 26 26 36 26 26 36 26 36 36 36 26 27 6 39 39 39 39 39 39 39 39 39 39 39 39 39 39 39 39 39 39 39 7 25
26 36 26 36 26 36 36 26 36 26 26 36 26 26 36 26 26 27 32 87 65 66 66 66 66 66 66 66 66 66 66 66 66 66 66 66 66 67 30 25
26 26 26 36 36 36 26 26 26 36 36 26 36 26 26 36 26 27 32 80 73 76 77 74 74 74 74 76 77 74 74 74 74 76 77 74 74 75 30 25
36 36 36 26 36 26 36 26 36 36 26 26 26 36 26 26 26 27 32 87 73 84 85 74 74 74 74 84 85 74 74 74 74 84 85 74 74 75 30 25
26 36 26 36 26 26 26 26 26 26 36 36 36 36 26 36 26 27 32 71 73 74 74 74 74 74 74 74 74 74 74 74 74 74 74 74 74 75 30 25
36 26 26 26 26 26 36 26 36 26 26 26 26 26 36 36 26 27 32 86 81 82 82 82 82 82 82 82 82 82 82 82 82 82 82 82 82 83 30 25
26 36 26 36 36 26 26 26 36 26 36 26 36 36 26 36 36 27 14 23 23 23 23 23 23 23 23 23 23 23 23 23 23 23 23 23 23 23 15 25
26 36 26 20 34 34 34 34 21 26 36 36 36 26 36 26 36 28 18 18 18 18 18 18 18 18 18 18 18 18 18 18 18 18 18 18 18 18 18 29
26 20 34 35 10 12 10 1 25 36 26 36 20 34 34 34 34 34 34 34 34 34 34 34 34 34 34 34 34 34 21 26 36 36 36 36 36 36 36 26
26 27 2 12 11 11 3 5 25 36 36 26 27 11 1 2 3 12 9 5 13 11 9 5 3 4 4 11 11 11 25 36 36 26 36 26 36 26 36 36
20 35 3 5 10 1 1 13 25 20 34 34 35 10 1 10 2 4 1 5 9 10 2 5 4 10 1 2 5 1 25 26 36 26 36 36 36 36 26 26
27 5 12 1 1 5 9 13 25 27 4 2 3 1 11 10 13 2 12 10 2 12 2 2 1 11 4 11 13 11 25 36 26 26 26 26 36 36 36 26
27 11 13 1 1 3 2 12 25 27 5 13 4 13 13 9 13 12 5 9 2 2 13 4 11 9 9 11 1 9 25 26 26 26 26 26 36 26 36 26
27 11 2 2 13 3 1 13 33 35 4 5 4 2 4 11 5 4 9 1 11 4 13 13 12 3 2 11 9 3 25 36 36 26 26 26 26 36 26 26
27 11 10 9 2 13 10 1 11 12 1 10 13 1 1 10 3 3 1 11 4 3 3 3 5 12 9 12 12 4 33 34 34 34 34 34 34 34 34 21
27 2 1 3 12 11 3 2 5 3 9 3 13 13 3 11 9 3 4 5 1 2 11 13 5 4 2 4 5 10 1 5 5 3 2 2 2 1 2 25
27 3 2 12 9 5 1 1 17 19 13 9 10 5 9 4 1 4 4 5 1 4 11 9 3 12 4 13 11 11 2 3 1 1 1 5 1 2 1 25
27 12 13 1 12 12 1 17 29 27 10 3 13 4 10 3 5 1 12 13 13 13 13 3 1 10 5 12 2 13 1 2 1 1 5 2 2 3 3 25
27 5 11 2 2 9 17 29 36 27 2 13 13 12 10 10 10 1 5 11 4 9 5 1 1 13 1 12 3 1 17 18 18 18 18 18 18 18 18 29
27 1 5 10 9 10 25 36 26 27 11 9 12 4 9 5 9 3 5 10 9 11 10 4 1 9 12 3 12 10 25 36 26 26 26 36 36 26 36 36
28 18 18 18 18 18 29 26 36 27 10 10 13 1 5 12 13 5 9 9 13 4 3 10 4 10 2 13 2 13 25 26 26 36 36 36 36 36 36 26
26 26 26 36 26 36 36 26 26 27 13 10 10 3 5 2 10 10 3 9 2 11 4 10 13 5 1 1 2 13 25 26 36 26 36 26 26 26 36 26
36 36 26 36 36 26 26 26 26 27 4 13 12 10 12 3 11 10 11 12 10 12 3 9 12 4 10 12 11 4 25 26 26 36 26 36 36 36 26 26
36 36 26 36 36 36 36 26 36 27 3 5 13 5 9 12 5 4 12 9 9 2 12 2 13 10 2 10 5 3 25 36 26 36 36 36 36 36 36 26
26 26 26 26 36 26 26 26 26 27 12 10 5 3 12 1 5 12 1 1 11 1 12 9 13 10 5 12 4 13 25 36 36 26 26 36 36 36 26 26
26 36 36 26 26 26 36 26 26 27 13 1 5 4 9 2 9 4 9 1 5 3 12 11 12 11 3 10 13 2 25 26 36 26 26 26 36 36 26 36
36 26 36 26 36 26 26 36 36 27 3 3 13 10 5 10 11 4 10 4 3 13 1 12 1 2 11 13 3 9 25 36 36 26 26 36 26 26 26 36
26 26 26 36 26 26 26 36 26 27 9 13 1 13 13 3 4 5 2 13 10 9 12 4 10 9 5 10 2 5 25 26 36 26 36 36 36 26 26 26
36 36 26 26 36 26 26 26 36 27 4 10 13 1 10 10 13 2 12 3 10 10 12 3 4 13 3 11 4 2 25 36 36 26 26 26 36 36 26 26
36 36 26 36 36 26 36 36 26 28 18 18 18 18 18 18 18 18 18 18 18 18 18 18 18 18 18 18 18 18 29 36 36 36 26 36 26 26 36 26
36 36 36 36 36 26 36 26 36 36 26 26 26 36 36 36 36 36 26 26 36 26 26 26 26 36 36 26 36 36 36 36 26 26 36 26 36 26 26 36
36 26 26 36 36 36 36 26 26 26 26 20 34 34 34 34 34 34 34 34 21 36 36 26 36 36 36 26 36 26 36 26 36 36 36 26 36 36 36 36
26 36 26 36 26 26 36 26 26 36 26 27 6 39 39 39 39 39 39 7 25 36 36 36 26 26 26 26 26 36 26 26 26 36 26 36 26 26 26 26
36 36 26 36 26 36 36 36 36 26 26 27 32 86 31 31 31 31 31 30 25 26 36 36 36 26 36 26 36 36 26 36 36 36 26 26 36 36 36 26
26 26 26 26 36 26 36 26 36 26 26 27 32 31 31 31 31 31 31 30 25 36 36 26 26 36 36 26 36 36 26 26 36 36 36 36 36 26 36 26
36 36 36 26 36 36 36 26 26 26 36 27 32 31 31 31 31 22 23 15 25 36 26 26 36 26 36 36 36 26 26 36 26 36 36 36 26 26 26 26
36 26 26 26 26 26 36 26 26 26 36 27 32 31 31 31 31 30 13 11 25 36 36 36 26 36 36 26 36 36 36 26 26 26 26 36 36 26 36 26
26 36 36 26 26 36 36 36 36 36 26 27 14 23 23 23 23 15 11 5 25 26 26 26 36 36 36 36 36 26 36 26 36 36 26 36 26 36 26 26
26 36 36 36 26 36 26 26 36 36 26 28 18 18 18 18 18 18 18 18 29 26 26 36 36 36 36 36 26 36 36 26 36 36 26 36 36 26 36 36