76 82 82 82 82 82 82 82 82 82 82 83 81 82 82 82 82 82 82 82 82 82 82 82 83 81 82 82 82 82 82 82 82 82 82 82 82 82 82 77 
75 88 72 70 87 87 70 70 70 72 72 70 72 88 70 88 70 70 70 70 70 70 70 70 70 70 70 70 70 70 70 70 70 70 70 70 70 70 70 73 
75 87 87 72 70 70 70 70 70 70 70 70 70 70 70 70 70 70 70 70 70 70 70 70 72 70 87 87 87 70 70 72 87 71 72 88 87 71 70 73 
75 87 70 71 70 70 72 70 88 88 70 70 72 70 70 87 70 70 87 70 71 72 70 70 70 87 71 70 70 71 88 70 70 88 70 70 70 70 70 73 
75 87 70 70 70 88 72 72 65 66 67 72 70 70 72 88 87 70 71 70 72 71 88 22 23 23 23 23 23 23 23 23 23 23 23 23 24 88 70 73 
75 70 70 70 70 70 70 70 81 82 83 70 70 70 70 70 70 71 70 70 70 88 71 30 93 128 93 92 110 96 17 18 18 18 18 19 32 72 70 73 
75 70 70 87 70 70 70 70 70 70 70 70 87 76 77 70 70 70 70 70 70 87 72 30 105 106 107 90 126 126 25 26 26 26 26 27 32 70 70 73 
75 87 70 70 70 70 87 72 70 70 70 87 88 84 85 71 70 70 70 70 70 71 70 30 121 122 123 126 101 93 25 26 26 26 26 27 32 72 70 73 
75 70 70 70 70 70 70 70 70 70 70 70 87 70 71 70 70 87 70 70 70 71 70 30 137 138 139 142 110 110 25 26 26 26 26 27 32 70 70 81 
75 70 70 72 70 70 88 70 87 70 71 70 70 70 88 70 70 70 70 70 70 70 70 30 93 126 126 89 111 96 33 34 34 34 34 35 32 70 70 65 
83 70 71 71 72 70 70 72 8 8 70 70 70 70 70 70 70 71 70 70 70 72 71 38 39 39 39 39 39 39 39 39 39 39 39 39 40 87 70 73 
67 70 70 70 70 70 87 70 8 8 70 70 71 70 71 70 70 70 70 70 70 70 70 70 70 70 88 87 70 71 72 70 22 23 23 23 24 72 70 73 
75 70 70 70 70 88 70 87 87 70 70 70 70 70 87 71 70 88 70 72 70 70 87 70 70 70 97 98 99 70 70 72 30 133 108 109 32 71 70 73 
75 70 70 70 88 87 70 70 70 88 71 87 88 70 70 70 70 70 70 70 70 70 70 88 70 70 113 37 115 70 87 70 30 89 124 125 32 71 70 73 
75 70 70 87 87 70 71 70 46 47 47 47 47 48 70 88 70 70 72 70 87 70 70 70 71 70 129 130 131 88 70 70 38 39 39 39 40 70 70 73 
75 70 70 70 70 87 70 70 54 55 55 55 55 56 70 71 70 71 70 72 71 70 70 70 87 70 70 70 71 70 87 70 70 70 70 88 87 72 70 73 
75 70 70 87 70 70 87 72 54 55 55 55 55 56 70 70 70 70 65 66 67 70 70 70 70 70 70 72 70 88 70 71 70 87 70 70 70 70 70 73 
75 87 70 70 70 70 72 87 54 55 55 55 55 56 70 71 70 87 73 74 75 70 70 88 70 70 70 70 70 70 70 70 87 70 88 70 72 70 71 73 
75 71 70 70 70 70 70 87 62 63 63 63 63 64 70 87 70 72 73 74 75 70 70 70 72 70 70 88 87 70 87 70 88 70 70 70 70 70 70 73 
75 88 88 70 70 70 70 72 88 71 87 70 87 70 88 70 70 71 81 82 83 70 70 70 70 70 70 72 70 70 88 70 70 71 71 70 70 70 70 73 
75 70 70 87 70 70 88 88 70 70 88 70 71 70 70 71 70 70 87 72 70 70 70 65 66 67 72 70 87 70 70 70 70 70 70 70 88 71 87 81 
75 87 70 70 70 70 87 70 70 70 70 70 70 70 70 70 70 70 70 87 87 70 70 81 82 83 70 71 72 70 70 70 72 70 88 70 70 72 87 65 
75 70 70 70 72 70 70 70 70 70 70 87 70 70 87 70 70 72 88 70 88 71 70 70 87 70 70 70 70 70 70 70 88 70 88 70 70 70 70 73 
75 70 87 70 71 87 88 41 42 42 42 42 42 42 43 88 71 70 70 70 72 70 70 70 70 70 70 70 87 70 70 70 71 70 70 70 70 70 70 73 
75 70 70 70 87 70 70 49 60 61 60 61 60 61 51 71 72 71 70 70 88 87 87 70 88 70 70 70 70 70 70 70 72 72 70 88 88 71 70 81 
75 72 72 70 70 70 70 49 68 69 68 69 68 69 51 70 72 70 70 70 70 70 70 72 70 87 71 88 88 70 70 70 71 76 77 71 70 72 70 65 
83 70 71 70 88 70 70 57 58 58 58 58 58 58 59 70 70 71 72 70 71 70 41 42 43 87 72 72 87 70 70 70 72 84 85 87 70 70 70 73 
67 70 70 70 87 88 88 70 70 87 70 88 70 72 70 71 70 70 71 70 88 72 49 50 51 70 70 70 70 70 72 87 88 87 88 70 70 72 70 73 
75 88 70 70 70 70 70 70 70 70 70 70 70 71 88 70 70 72 70 70 88 70 49 50 51 70 70 70 87 70 70 70 72 71 70 70 70 70 70 73 
75 70 70 70 88 70 70 87 70 70 71 97 98 99 97 98 99 70 88 70 70 70 57 58 59 70 70 70 70 88 70 87 70 71 70 70 70 70 70 73 
75 87 70 70 70 88 87 71 71 70 70 113 95 115 113 5 115 70 70 70 70 70 71 88 70 70 88 87 46 47 48 70 87 70 71 70 70 70 70 73 
75 70 70 70 70 88 70 72 70 70 70 129 130 131 129 130 131 70 70 70 70 70 70 87 88 70 70 70 62 63 64 87 70 70 70 70 72 70 70 73 
75 72 70 87 70 70 72 88 70 88 70 70 70 70 87 71 70 70 70 70 70 88 87 87 70 70 70 70 70 88 70 87 70 70 70 70 87 70 70 73 
75 71 72 71 70 72 87 87 70 70 70 70 70 70 70 70 70 70 70 87 70 71 70 72 88 88 70 70 70 71 70 70 70 71 87 70 87 87 70 73 
75 70 70 88 70 70 70 87 70 71 70 88 72 70 71 88 87 71 70 88 70 70 70 70 71 71 70 70 70 70 70 70 70 87 70 70 70 72 70 73 
75 88 70 70 87 70 70 70 70 70 70 70 70 70 70 70 70 70 70 72 70 70 87 87 88 87 70 70 70 71 70 71 71 70 70 70 70 70 70 73 
75 72 70 87 70 70 72 70 70 70 70 70 70 70 70 87 88 87 70 70 70 70 70 70 70 70 70 70 71 87 71 72 70 70 88 70 70 70 70 73 
75 72 70 87 72 87 70 70 71 70 71 70 70 87 70 88 87 71 70 88 72 87 88 88 70 70 70 70 72 87 72 70 70 72 70 88 87 70 31 73 
75 72 72 72 71 70 70 70 88 70 87 72 70 70 88 70 70 72 71 72 70 70 70 70 70 70 70 70 88 88 70 70 70 70 31 31 31 31 31 73 
84 66 66 66 66 66 66 66 66 66 66 66 66 66 66 67 65 66 66 66 66 66 66 66 66 66 66 66 66 67 65 66 66 66 66 66 66 66 66 85