26 26 26 36 36 36 36 36 26 26 26 26 26 26 26 26 26 26 26 26 26 26 26 26 26 26 26 26 26 26 26 26 26 26 26 26 26 26 26 26
26 26 26 36 36 36 36 36 36 36 36 36 26 26 26 26 26 26 36 36 36 36 36 36 36 36 36 36 36 26 26 26 26 26 26 26 26 26 26 26
26 26 26 26 36 36 36 36 36 36 26 36 26 26 26 36 36 36 36 26 26 26 26 26 26 26 26 26 26 26 26 36 36 36 36 26 26 26 26 26
26 26 26 36 36 36 36 36 36 26 26 26 26 26 26 26 26 26 26 26 26 26 26 26 26 26 26 26 26 26 26 26 26 26 26 26 26 26 26 26
26 26 26 26 36 34 34 34 34 34 34 34 34 34 34 34 34 34 34 34 34 34 34 34 34 34 34 34 34 34 34 34 34 34 34 34 26 26 26 26
26 26 26 26 27 97 98 98 98 98 98 98 98 98 98 98 98 98 98 98 98 98 98 98 98 98 98 98 98 98 98 98 98 98 98 99 25 26 26 26
26 26 26 26 27 113 2 2 2 2 2 2 2 2 5 2 2 2 2 2 2 2 2 2 2 2 2 2 100 2 2 2 2 2 2 115 25 26 26 26
26 26 26 26 27 113 2 2 2 2 2 2 2 2 5 2 2 2 37 2 2 2 37 2 2 2 2 2 115 2 2 2 2 2 2 115 25 26 26 26
26 26 26 26 27 113 2 2 2 2 2 2 2 2 5 2 2 2 2 2 2 2 2 2 2 2 2 2 116 2 2 2 2 2 2 115 25 26 26 26
26 26 26 26 27 113 2 2 92 2 2 2 2 2 5 5 2 2 2 2 2 2 2 2 2 2 2 2 2 2 2 2 2 2 2 115 25 26 26 26
26 26 26 26 27 113 2 2 2 2 2 2 2 2 2 2 2 2 2 2 2 2 2 2 5 2 2 2 2 2 2 2 2 2 2 115 25 26 26 26
26 26 26 26 27 113 2 2 2 2 2 2 2 2 2 2 2 2 2 2 2 2 2 2 5 2 2 2 2 97 98 99 2 2 2 115 25 26 26 26
26 26 26 26 27 113 2 2 2 2 2 2 2 2 2 2 2 2 2 2 2 2 2 2 5 2 2 2 2 113 2 115 2 2 2 115 25 26 26 26
26 26 26 26 27 113 2 2 2 2 2 2 5 2 2 2 90 2 2 2 2 2 2 2 2 2 2 2 2 129 130 131 2 2 2 115 25 26 26 26
26 26 26 26 27 113 105 106 107 2 102 103 5 2 2 2 2 2 2 2 2 17 18 19 2 5 5 5 2 2 2 2 2 2 2 115 25 26 26 26
26 26 26 26 27 113 121 122 123 2 118 119 120 2 2 2 2 2 2 2 2 25 26 27 2 2 2 2 2 2 2 2 2 2 2 115 25 26 26 26
26 26 26 26 27 113 137 138 139 2 134 135 136 2 2 2 2 2 2 2 2 33 34 35 2 2 2 2 2 2 2 2 2 2 2 115 25 26 26 26
26 26 26 26 27 113 2 31 31 31 31 31 2 2 2 2 2 2 2 2 2 2 2 2 2 2 2 2 2 2 2 2 2 2 2 115 25 26 26 26
26 26 26 26 26 18 18 18 18 18 18 18 18 18 18 18 18 18 19 2 2 17 18 18 18 18 18 18 18 18 18 18 18 18 18 18 26 26 26 26
26 26 26 26 26 26 26 26 26 26 26 26 26 26 26 26 26 26 27 2 2 25 26 26 26 26 26 26 26 26 26 26 26 26 26 26 26 26 26 36
26 36 36 26 26 26 26 26 26 26 26 26 26 26 26 26 26 26 27 2 2 25 26 26 26 26 26 26 26 26 26 26 26 26 26 26 26 26 26 36
26 36 26 26 26 34 34 34 34 34 34 34 34 34 34 34 34 34 35 2 2 33 34 34 34 34 34 34 34 34 34 34 34 34 34 34 26 26 26 36
26 36 26 26 27 113 2 2 2 2 2 2 2 2 2 5 2 2 2 2 2 2 2 2 2 2 2 2 2 2 2 2 2 2 2 115 25 26 26 36
26 36 26 26 27 113 2 2 2 2 2 2 2 2 2 5 2 2 2 2 2 2 5 2 2 2 2 2 2 2 2 2 2 2 2 115 25 26 26 36
26 36 26 26 27 113 2 2 5 2 2 2 2 2 2 5 5 2 2 2 2 2 5 2 2 2 2 2 2 2 2 2 2 2 2 115 25 26 26 36
26 36 26 26 27 113 2 2 5 2 2 2 2 2 2 5 2 2 2 5 2 2 2 2 2 2 2 2 2 2 2 2 2 2 2 115 25 26 36 36
26 36 26 26 27 113 2 2 2 2 2 5 5 5 5 5 2 2 2 2 5 5 2 2 2 2 2 2 2 2 5 5 5 2 2 115 25 26 36 26
26 36 26 26 27 113 2 2 2 2 2 2 2 2 2 2 2 2 2 2 2 2 2 2 2 2 2 2 2 2 2 2 2 2 2 115 25 26 26 26
26 36 26 26 27 113 2 2 2 2 2 2 2 2 2 2 2 2 2 2 2 2 2 2 2 2 2 2 2 2 2 2 2 2 2 115 25 26 26 26
26 26 26 26 27 113 2 2 2 2 2 2 2 2 2 2 2 2 2 2 2 2 2 2 2 2 2 2 2 2 2 2 2 2 2 115 25 26 26 26
26 26 26 26 27 113 2 2 2 2 2 2 2 2 2 2 2 2 2 2 2 2 2 2 2 2 2 2 2 2 2 2 2 2 2 115 25 26 26 26
26 26 26 26 27 113 2 2 5 5 2 2 2 2 2 2 2 2 2 2 2 2 2 2 2 2 2 2 2 2 2 2 2 2 2 115 25 26 26 26
26 26 26 26 27 113 2 2 2 2 2 2 2 2 2 2 2 2 2 2 2 2 2 2 2 2 2 2 5 5 2 2 2 2 2 115 25 26 26 26
26 26 26 26 27 113 2 2 2 2 2 2 2 2 2 2 2 2 2 2 2 2 2 2 2 2 2 2 2 5 2 2 2 2 2 115 25 26 26 26
26 26 26 26 27 113 2 2 2 2 2 2 2 2 2 2 2 2 2 2 2 2 2 2 2 2 2 2 2 5 2 2 2 2 2 115 25 26 26 26
26 26 26 26 27 129 130 130 130 130 130 130 130 130 130 130 130 130 130 130 130 130 130 130 130 130 130 130 130 130 130 130 130 130 130 131 25 26 26 26
26 26 26 36 36 18 18 18 18 18 18 18 18 18 18 18 18 18 18 18 18 18 18 18 18 18 18 18 18 18 18 18 18 18 18 18 26 26 26 26
26 26 26 26 26 26 26 26 26 26 26 26 26 26 26 26 26 26 26 26 26 26 26 26 36 36 36 26 26 26 26 26 26 26 26 26 26 26 26 26
26 26 26 26 26 26 26 26 26 26 26 26 26 26 26 26 26 26 26 26 36 36 36 36 36 36 26 26 26 26 26 26 26 26 26 26 26 26 26 26
26 26 26 26 26 26 26 26 26 26 26 26 26 26 26 26 26 26 26 26 26 26 26 26 26 26 26 26 26 26 26 26 26 26 26 26 26 26 26 26