26 26 26 36 36 36 36 36 26 26 26 26 26 26 26 26 26 26 26 26 26 26 26 26 26 26 26 26 26 26 26 26 26 26 26 26 26 26 26 26
26 26 26 36 36 36 36 36 36 36 36 36 26 26 26 26 26 26 36 36 36 36 36 36 36 36 36 36 36 26 26 26 26 26 26 26 26 26 26 26
26 26 26 26 36 36 36 36 36 36 26 36 26 26 26 36 36 36 36 26 26 26 26 26 26 26 26 26 26 26 26 36 36 36 36 26 26 26 26 26
26 26 26 36 36 36 36 36 36 26 26 26 26 26 26 26 26 26 26 26 26 26 26 26 26 26 26 26 26 26 26 26 26 26 26 26 26 26 26 26
26 26 26 26 36 34 34 34 34 34 34 34 34 34 34 34 34 34 34 34 34 34 34 34 34 34 34 34 34 34 34 34 34 34 34 34 26 26 26 26
26 26 26 26 27 97 98 98 98 98 98 98 98 98 98 98 98 98 98 98 98 98 98 98 98 98 98 98 98 98 98 98 98 98 98 99 25 26 26 26
26 26 26 26 27 113 2 2 2 2 2 2 2 97 99 2 2 2 2 2 2 2 2 2 2 2 2 2 2 2 2 113 2 2 2 115 25 26 26 26
26 26 26 26 27 113 2 2 2 2 2 2 2 2 2 2 2 2 2 2 2 2 2 2 2 2 2 2 2 2 2 129 130 130 2 115 25 26 26 26
26 26 26 26 27 113 2 2 2 2 2 2 2 2 2 2 2 2 2 2 2 2 2 2 2 2 2 2 2 2 2 2 2 2 2 115 25 26 26 26
26 26 26 26 27 113 2 2 2 2 2 2 2 2 2 2 2 2 2 2 2 2 2 2 2 2 2 2 2 2 2 2 2 2 2 115 25 26 26 26
26 26 26 26 27 113 2 2 2 2 2 2 2 2 97 98 98 99 2 2 2 2 2 2 2 2 2 2 2 2 2 2 2 2 2 115 25 26 26 26
26 26 26 26 27 113 2 2 2 2 2 2 2 2 113 108 109 115 2 2 2 2 2 2 2 2 2 2 2 2 2 2 2 2 2 115 25 26 26 26
26 26 26 26 27 113 2 2 2 2 2 2 2 2 113 124 125 115 2 2 2 2 2 2 2 2 2 2 2 2 2 2 2 2 2 115 25 26 26 26
26 26 26 26 27 113 2 2 2 2 2 2 2 2 113 2 2 115 2 2 97 98 99 2 2 2 2 2 2 2 2 2 2 2 2 115 25 26 26 26
26 26 26 26 27 113 105 2 2 2 2 2 2 2 2 2 2 2 2 2 113 2 115 2 2 2 2 2 2 2 2 2 2 2 2 115 25 26 26 26
26 26 26 26 27 113 2 2 2 2 2 2 2 2 2 2 2 2 2 2 129 130 131 2 2 2 2 2 2 2 2 2 2 2 2 115 25 26 26 26
26 26 26 26 27 113 2 2 2 2 2 2 2 2 2 2 2 2 2 2 2 2 2 2 2 2 2 2 2 2 2 2 2 2 2 115 25 26 26 26
26 26 26 26 27 113 2 2 2 2 2 2 2 2 2 2 2 2 2 2 2 2 2 2 2 2 2 98 98 98 98 98 98 98 98 115 25 26 26 26
26 26 26 26 27 113 2 2 2 2 2 2 100 2 2 2 2 2 2 2 2 2 2 2 2 2 2 113 2 2 2 2 2 2 2 115 25 26 26 26
26 26 26 26 27 113 2 2 2 2 2 2 116 2 2 2 2 2 2 2 2 2 2 2 2 2 2 2 2 2 2 2 2 2 2 115 25 26 26 36
26 36 36 26 27 113 2 2 2 2 2 2 2 2 2 2 2 2 2 2 2 2 2 2 2 2 2 2 2 2 2 2 2 2 2 115 25 26 26 36
26 36 26 26 27 113 2 2 2 2 2 2 2 2 2 97 98 99 2 2 2 2 2 2 2 2 2 2 2 2 2 2 2 2 2 115 25 26 26 36
26 36 26 26 27 113 2 2 2 2 2 2 2 2 2 2 2 2 2 2 2 2 2 2 2 98 99 2 2 2 2 2 2 2 2 115 25 26 26 36
26 36 26 26 27 113 2 2 2 2 2 97 98 99 2 2 2 2 2 2 2 2 2 2 2 2 116 2 2 2 2 2 2 2 2 115 25 26 26 36
26 36 26 26 27 113 2 2 2 2 2 113 2 115 2 2 2 2 2 2 2 2 2 2 2 2 2 2 2 2 2 2 2 2 2 115 25 26 26 36
26 36 26 26 27 113 2 2 2 2 2 113 2 115 2 2 2 2 2 2 17 18 19 74 74 2 2 2 2 2 2 2 2 2 2 115 25 26 36 36
26 36 26 26 27 113 2 2 2 2 2 2 2 2 2 2 2 2 2 2 25 26 27 2 2 2 2 2 2 2 2 2 2 2 2 115 25 26 36 26
26 36 26 26 27 113 2 2 2 2 2 2 2 2 2 2 105 106 107 2 25 26 27 2 2 74 74 2 2 2 2 2 2 2 2 115 25 26 26 26
26 36 26 26 27 113 2 2 2 2 2 2 2 2 2 2 121 122 123 2 25 26 27 2 74 70 70 74 2 2 2 2 2 2 2 115 25 26 26 26
26 26 26 26 27 113 2 2 2 2 2 2 2 2 2 2 137 138 139 2 33 34 35 2 74 70 70 74 2 2 2 2 2 2 2 115 25 26 26 26
26 26 26 26 27 113 2 2 2 2 2 2 2 2 2 2 2 2 2 2 2 2 2 2 74 70 70 74 2 2 2 2 2 2 2 115 25 26 26 26
26 26 26 26 27 113 2 2 2 2 2 2 2 2 2 2 2 2 2 2 2 2 2 2 74 70 70 74 2 2 2 2 2 2 2 115 25 26 26 26
26 26 26 26 27 113 2 2 2 2 2 2 2 2 2 2 97 98 2 2 2 2 2 2 2 74 74 2 2 2 2 2 2 2 2 115 25 26 26 26
26 26 26 26 27 113 2 2 2 2 2 2 2 2 2 2 113 2 2 2 2 2 2 2 2 2 2 2 2 2 2 2 2 2 2 115 25 26 26 26
26 26 26 26 27 113 2 2 2 2 2 2 2 2 2 2 113 2 2 2 2 2 2 2 2 2 2 2 2 2 2 2 2 2 2 115 25 26 26 26
26 26 26 26 27 129 130 130 130 130 130 130 130 130 130 130 130 130 130 130 130 130 130 130 130 130 130 130 130 130 130 130 130 130 130 131 25 26 26 26
26 26 26 36 36 18 18 18 18 18 18 18 18 18 18 18 18 18 18 18 18 18 18 18 18 18 18 18 18 18 18 18 18 18 18 18 26 26 26 26
26 26 26 26 26 26 26 26 26 26 26 26 26 26 26 26 26 26 26 26 26 26 26 26 36 36 36 26 26 26 26 26 26 26 26 26 26 26 26 26
26 26 26 26 26 26 26 26 26 26 26 26 26 26 26 26 26 26 26 26 36 36 36 36 36 36 26 26 26 26 26 26 26 26 26 26 26 26 26 26
26 26 26 26 26 26 26 26 26 26 26 26 26 26 26 26 26 26 26 26 26 26 26 26 26 26 26 26 26 26 26 26 26 26 26 26 26 26 26 26