16 16 16 16 16 16 16 16 16 16 16 81 82 82 82 82 82 82 82 82 82 82 82 83 57 58 58 58 58 58 58 58 58 58 58 58 58 58 58 61 
16 79 78 70 70 78 70 70 70 88 70 70 70 71 70 70 70 70 70 70 70 70 78 71 70 70 70 70 87 70 79 78 70 70 70 70 80 70 70 49 
16 70 70 70 87 70 70 70 70 70 70 70 70 71 70 70 70 70 72 71 88 70 70 70 70 70 70 70 70 70 70 70 70 70 70 70 70 70 70 49 
16 78 70 70 71 70 71 78 70 78 70 70 70 70 70 70 71 78 78 70 70 70 70 70 70 70 71 72 70 70 41 42 43 79 70 70 70 72 70 49 
16 70 70 70 70 70 78 70 70 70 70 70 70 70 70 80 70 70 70 70 78 70 70 70 70 70 71 70 70 78 49 50 51 70 70 70 70 87 70 49 
16 70 70 71 70 78 79 71 71 70 71 70 70 78 70 70 70 70 70 70 70 78 71 70 70 87 70 70 70 70 57 58 59 70 71 70 70 70 70 49 
16 70 70 70 71 70 70 70 70 70 70 70 70 70 70 78 70 70 78 70 70 70 88 70 78 70 70 79 71 70 70 70 70 70 70 78 70 70 70 49 
16 70 70 70 78 70 70 70 70 72 71 70 71 79 70 70 72 70 70 70 70 78 70 70 71 70 72 70 70 70 70 71 70 88 70 70 88 70 70 49 
16 79 70 70 70 70 70 70 70 80 70 70 70 70 70 70 70 70 70 70 70 70 70 80 70 70 87 70 70 70 70 70 70 70 78 78 70 87 71 49 
16 70 70 70 70 71 88 70 70 70 70 70 65 66 67 70 78 79 70 70 70 70 78 70 70 70 70 70 71 70 70 70 70 78 70 71 78 70 70 57 
16 70 70 78 80 70 70 70 70 78 70 78 81 82 83 70 80 70 88 70 70 72 70 70 70 70 70 78 70 70 70 70 70 70 70 70 70 70 70 65 
67 70 80 70 70 70 78 70 70 71 70 79 70 80 70 70 70 70 78 97 98 98 98 99 70 70 70 70 78 70 70 76 77 70 78 71 70 70 70 73 
75 70 70 70 70 70 71 60 61 70 70 70 17 18 19 70 70 70 70 113 102 103 104 115 78 70 70 78 71 70 70 84 85 70 70 70 70 88 70 73 
75 70 70 70 71 70 70 68 69 70 70 71 33 34 35 70 70 70 70 113 118 119 120 115 71 70 70 70 79 78 70 70 78 70 70 80 70 70 70 73 
75 70 71 70 78 70 70 78 88 78 70 70 71 70 70 70 87 70 71 113 134 135 136 115 70 70 70 70 78 71 70 70 70 70 70 70 78 70 87 73 
75 70 70 71 70 70 70 70 70 78 71 70 41 42 43 72 70 70 70 129 132 114 130 131 8 8 8 8 8 8 8 8 8 8 78 70 71 70 70 73 
75 70 70 70 78 70 70 70 70 70 70 78 57 58 59 70 70 71 87 71 70 70 70 70 8 22 23 23 23 23 23 23 24 8 70 70 70 80 70 73 
75 70 71 70 71 70 70 70 70 70 70 70 70 70 70 70 88 70 70 70 70 70 70 70 8 30 17 18 18 18 18 19 32 8 70 70 71 70 70 73 
75 71 70 70 78 70 70 70 70 70 71 70 70 87 70 78 70 70 70 70 78 70 70 71 8 30 25 26 26 26 26 27 32 8 70 70 70 70 70 73 
75 71 70 70 70 70 70 70 70 70 70 70 70 70 70 70 88 70 70 71 70 70 70 70 8 30 25 26 26 26 26 27 32 8 70 70 88 70 87 73 
75 70 70 70 70 70 8 8 8 8 8 8 8 8 70 70 70 70 70 70 70 71 71 70 8 30 25 26 26 26 26 27 32 8 70 70 70 70 70 73 
75 70 70 70 70 70 8 80 80 80 80 80 80 8 70 70 70 70 70 70 70 70 70 78 8 30 25 26 26 26 26 27 32 8 78 70 71 70 70 73 
75 70 79 71 88 70 8 80 80 80 80 80 80 8 70 70 70 70 70 71 70 70 87 70 8 30 25 26 26 26 26 27 32 8 70 70 70 70 70 73 
75 78 70 70 71 70 8 96 96 96 96 96 96 8 70 70 71 70 78 70 70 70 70 70 8 30 33 34 34 34 34 35 32 8 70 70 70 78 70 73 
75 70 70 70 78 70 8 96 96 96 96 96 96 8 78 70 79 70 70 71 70 70 8 8 8 38 39 39 39 39 39 39 40 8 79 70 80 70 70 73 
75 70 70 70 70 70 8 8 8 8 8 8 8 8 70 70 70 70 70 70 70 70 8 105 106 107 8 8 8 8 8 8 8 8 70 70 80 71 70 73 
83 70 70 70 70 70 70 70 70 70 71 78 87 70 70 70 70 70 70 70 71 70 8 121 122 123 8 70 78 70 78 70 78 70 71 78 78 70 70 73 
43 79 71 70 70 70 70 70 70 70 70 71 70 70 70 70 70 70 71 70 70 70 8 137 138 139 8 70 70 70 70 71 70 70 87 71 70 70 70 73 
51 70 70 70 70 70 70 70 70 70 78 70 70 70 70 70 70 70 70 70 78 79 8 8 8 8 8 71 70 80 70 87 72 70 78 70 70 70 70 81 
51 70 70 70 79 70 70 70 78 70 79 70 87 70 70 70 70 70 70 70 70 80 70 70 70 70 79 70 70 70 70 70 70 70 70 72 70 70 70 16 
51 70 70 70 70 70 70 70 70 70 71 70 70 70 78 70 87 72 70 78 70 70 70 70 70 70 78 70 70 78 70 70 70 79 70 70 70 70 70 16 
51 70 71 78 70 70 70 70 70 70 70 70 70 71 72 70 71 70 78 70 70 70 70 70 70 70 70 70 70 71 70 65 66 67 70 70 70 70 71 16 
51 70 70 70 70 70 70 60 61 70 70 70 70 70 70 70 70 70 70 70 70 70 70 78 70 70 70 70 70 70 70 73 74 75 70 70 70 70 80 16 
51 70 70 70 71 72 70 68 69 71 70 70 70 70 70 70 70 70 70 70 70 87 87 70 71 70 70 70 70 87 70 81 82 83 70 70 70 79 70 16 
51 70 70 70 70 71 70 71 70 70 70 70 70 78 70 70 70 71 70 70 70 70 70 70 70 70 70 70 78 79 80 70 70 78 70 71 70 70 70 16 
51 71 70 70 70 78 70 78 70 70 70 70 70 70 79 70 70 70 78 70 78 70 78 72 88 70 71 70 70 70 70 70 70 70 70 70 70 71 71 16 
51 70 70 70 70 70 70 70 70 70 70 78 70 72 70 70 70 88 70 78 87 70 70 70 70 70 70 78 70 70 78 70 70 70 70 70 70 79 70 16 
51 70 79 70 70 70 70 79 70 70 70 70 70 70 70 70 70 70 78 70 70 70 70 70 70 79 70 72 70 70 70 70 71 70 70 70 78 88 87 16 
51 70 70 70 78 70 70 70 71 70 70 70 70 78 70 70 71 70 70 78 72 70 71 71 70 78 78 70 70 87 70 70 79 70 80 78 70 70 70 16 
68 42 42 42 42 42 42 42 42 42 42 65 66 66 66 66 66 66 66 66 66 66 66 66 66 66 66 66 66 67 16 16 16 16 16 16 16 16 16 16