74 74 74 74 74 74 74 74 74 74 74 74 74 74 74 74 74 74 74 74 74 74 74 74 74 74 74 74 74 74 74 74 74 74 74 74 74 74 74 74 
74 74 74 74 74 74 74 74 74 74 74 74 74 74 74 74 74 74 74 74 74 74 74 74 74 74 74 74 74 74 74 74 74 74 74 74 74 74 74 74 
74 74 74 74 74 74 74 74 74 74 74 74 74 74 74 74 74 74 74 74 74 74 74 74 74 74 74 74 74 74 74 74 74 74 74 74 74 74 74 74 
74 74 74 74 74 74 74 74 74 74 74 74 74 74 74 74 74 74 74 74 74 74 74 74 74 74 74 74 74 74 74 74 74 74 74 74 74 74 74 74 
74 74 74 74 74 74 74 74 74 74 74 74 74 74 74 74 74 74 74 74 74 74 74 74 74 74 74 74 74 74 74 74 74 74 74 74 74 74 74 74 
74 74 74 74 74 74 74 74 74 74 74 74 74 74 74 74 74 74 74 74 74 74 74 74 74 74 74 74 74 74 74 74 74 74 74 74 74 74 74 74 
74 74 74 74 74 74 74 74 74 74 74 74 74 74 74 74 74 74 74 74 74 74 74 74 74 74 74 74 74 74 74 74 74 74 74 74 74 74 74 74 
74 74 74 74 74 74 74 74 74 74 74 74 74 74 74 74 74 74 74 74 74 74 74 74 74 74 74 74 74 74 74 74 74 74 74 74 74 74 74 74 
74 74 74 74 74 74 74 74 74 74 74 74 74 74 74 74 74 74 74 74 74 74 74 74 74 74 74 74 74 74 74 74 74 74 74 74 74 74 74 74 
74 74 74 74 74 74 74 74 74 76 82 82 82 82 82 82 82 82 82 82 82 82 82 82 82 82 82 82 82 82 77 74 74 74 74 74 74 74 74 74 
74 74 74 74 74 74 74 74 74 75 86 70 70 70 71 70 70 87 70 70 70 70 79 70 72 70 70 70 71 72 73 74 74 74 74 74 74 74 74 74 
74 74 74 74 74 74 74 74 74 75 70 71 70 70 70 70 70 70 70 70 70 70 87 78 70 70 72 70 70 70 73 74 74 74 74 74 74 74 74 74 
74 74 74 74 74 74 74 74 74 75 70 70 70 87 70 72 70 70 70 70 71 70 79 80 71 70 70 71 71 72 73 74 74 74 74 74 74 74 74 74 
74 74 74 74 74 74 74 74 74 75 70 70 70 72 70 70 70 79 70 70 72 70 70 70 70 70 70 70 70 70 73 74 74 74 74 74 74 74 74 74 
74 74 74 74 74 74 74 74 74 75 71 72 70 71 70 70 70 87 70 71 72 70 71 70 71 79 71 71 70 70 73 74 74 74 74 74 74 74 74 74 
74 74 74 74 74 74 74 74 74 75 70 70 70 70 71 71 70 70 70 70 71 70 70 70 78 79 80 70 70 70 73 74 74 74 74 74 74 74 74 74 
74 74 74 74 74 74 74 74 74 75 70 79 70 72 70 70 70 71 72 70 70 70 72 72 71 70 70 72 70 72 73 74 74 74 74 74 74 74 74 74 
74 74 74 74 74 74 74 74 74 75 70 70 70 70 70 72 70 78 70 71 78 70 70 71 70 70 70 70 70 71 73 74 74 74 74 74 74 74 74 74 
74 74 74 74 74 74 74 74 74 75 72 72 70 79 70 70 70 70 72 70 78 70 70 70 70 72 70 70 79 70 73 74 74 74 74 74 74 74 74 74 
74 74 74 74 74 74 74 74 74 75 70 70 70 70 70 70 70 72 70 70 70 70 70 79 79 70 70 70 87 70 73 74 74 74 74 74 74 74 74 74 
74 74 74 74 74 74 74 74 74 75 70 70 79 70 70 79 80 70 70 79 70 71 78 79 70 70 70 70 70 71 73 74 74 74 74 74 74 74 74 74 
74 74 74 74 74 74 74 74 74 75 72 70 72 70 70 87 88 87 70 70 70 72 70 70 70 70 70 70 72 70 73 74 74 74 74 74 74 74 74 74 
74 74 74 74 74 74 74 74 74 75 70 70 71 70 70 70 70 70 70 71 70 70 70 72 70 70 79 70 70 72 73 74 74 74 74 74 74 74 74 74 
74 74 74 74 74 74 74 74 74 75 70 70 70 70 70 70 70 70 70 71 72 71 70 70 72 71 70 70 72 71 73 74 74 74 74 74 74 74 74 74 
74 74 74 74 74 74 74 74 74 75 70 70 70 71 70 70 70 70 78 70 70 72 70 70 70 72 71 70 70 70 73 74 74 74 74 74 74 74 74 74 
74 74 74 74 74 74 74 74 74 75 70 71 70 70 70 70 72 72 70 71 70 70 70 70 72 70 71 72 70 70 73 74 74 74 74 74 74 74 74 74 
74 74 74 74 74 74 74 74 74 75 78 79 80 79 70 70 87 70 71 72 79 80 79 70 70 72 70 70 70 71 73 74 74 74 74 74 74 74 74 74 
74 74 74 74 74 74 74 74 74 75 70 71 70 87 70 70 78 70 70 70 72 70 70 70 78 70 70 70 70 70 73 74 74 74 74 74 74 74 74 74 
74 74 74 74 74 74 74 74 74 75 72 70 72 70 72 70 78 70 70 70 70 70 70 72 70 70 70 70 70 70 73 74 74 74 74 74 74 74 74 74
74 74 74 74 74 74 74 74 74 75 70 72 87 72 70 70 70 70 70 78 70 80 70 70 87 70 72 71 71 71 73 74 74 74 74 74 74 74 74 74
74 74 74 74 74 74 74 74 74 84 66 66 66 66 66 66 66 66 66 66 66 66 66 66 66 66 66 66 66 66 85 74 74 74 74 74 74 74 74 74 
74 74 74 74 74 74 74 74 74 74 74 74 74 74 74 74 74 74 74 74 74 74 74 74 74 74 74 74 74 74 74 74 74 74 74 74 74 74 74 74 
74 74 74 74 74 74 74 74 74 74 74 74 74 74 74 74 74 74 74 74 74 74 74 74 74 74 74 74 74 74 74 74 74 74 74 74 74 74 74 74 
74 74 74 74 74 74 74 74 74 74 74 74 74 74 74 74 74 74 74 74 74 74 74 74 74 74 74 74 74 74 74 74 74 74 74 74 74 74 74 74 
74 74 74 74 74 74 74 74 74 74 74 74 74 74 74 74 74 74 74 74 74 74 74 74 74 74 74 74 74 74 74 74 74 74 74 74 74 74 74 74 
74 74 74 74 74 74 74 74 74 74 74 74 74 74 74 74 74 74 74 74 74 74 74 74 74 74 74 74 74 74 74 74 74 74 74 74 74 74 74 74 
74 74 74 74 74 74 74 74 74 74 74 74 74 74 74 74 74 74 74 74 74 74 74 74 74 74 74 74 74 74 74 74 74 74 74 74 74 74 74 74 
74 74 74 74 74 74 74 74 74 74 74 74 74 74 74 74 74 74 74 74 74 74 74 74 74 74 74 74 74 74 74 74 74 74 74 74 74 74 74 74 
74 74 74 74 74 74 74 74 74 74 74 74 74 74 74 74 74 74 74 74 74 74 74 74 74 74 74 74 74 74 74 74 74 74 74 74 74 74 74 74 
74 74 74 74 74 74 74 74 74 74 74 74 74 74 74 74 74 74 74 74 74 74 74 74 74 74 74 74 74 74 74 74 74 74 74 74 74 74 74 74