26 26 26 26 26 26 26 26 26 26 26 26 26 26 26 26 26 26 26 26 26 26 26 26 26 26 26 26 26 26 26 26 26 26 26 26 26 26 26 26
26 26 26 26 26 26 26 26 26 26 26 26 26 26 26 26 26 26 26 26 26 26 26 26 26 26 26 26 26 26 26 26 26 26 26 26 26 26 26 26
26 26 26 26 26 26 26 26 26 26 26 26 26 26 26 26 26 26 26 26 26 26 26 26 26 26 26 26 26 26 26 26 26 26 26 26 26 26 26 26
26 26 26 26 26 26 26 26 26 26 26 26 26 26 26 26 26 26 26 26 26 26 26 26 26 26 26 26 26 26 26 26 26 26 26 26 26 26 26 26
26 26 26 26 26 26 26 26 26 26 26 26 26 26 26 26 26 26 26 26 26 26 26 26 26 26 26 26 26 26 26 26 26 26 26 26 26 26 26 26
26 26 26 26 26 26 26 26 26 26 26 26 26 26 26 26 26 26 26 26 26 26 26 26 26 26 26 26 26 26 26 26 26 26 26 26 26 26 26 26
26 26 26 26 26 26 26 26 26 26 26 26 26 26 26 26 26 26 26 26 26 26 26 26 26 26 26 26 26 26 26 26 26 26 26 26 26 26 26 26
26 26 26 26 26 26 26 26 26 26 26 26 26 26 26 26 26 26 26 26 26 26 26 26 26 26 26 26 26 26 26 26 26 26 26 26 26 26 26 26
26 26 26 26 26 26 26 26 26 26 26 26 26 26 26 26 26 26 26 26 26 26 26 26 26 26 26 26 26 26 26 26 26 26 26 26 26 26 26 26
26 26 26 26 26 26 26 26 26 20 34 34 34 34 34 34 34 34 34 34 34 34 34 34 34 34 34 34 34 34 21 26 26 26 26 26 26 26 26 26
26 26 26 26 26 26 26 26 26 27 9 5 13 3 13 4 5 5 2 2 11 3 11 2 13 4 4 5 3 13 25 26 26 26 26 26 26 26 26 26
26 26 26 26 26 26 26 26 26 27 5 2 2 3 11 2 2 13 11 12 12 12 13 3 11 2 11 3 37 4 25 26 26 26 26 26 26 26 26 26
26 26 26 26 26 26 26 26 26 27 12 2 4 12 11 3 11 10 2 5 12 12 12 5 4 3 13 12 3 13 25 26 26 26 26 26 26 26 26 26
26 26 26 26 26 26 26 26 26 27 2 3 4 13 12 5 12 12 13 10 11 3 10 3 13 11 10 13 12 2 25 26 26 26 26 26 26 26 26 26
26 26 26 26 26 26 26 26 26 27 11 11 5 2 13 11 2 11 3 10 13 1 5 3 3 11 3 10 3 11 25 26 26 26 26 26 26 26 26 26
26 26 26 26 26 26 26 26 26 27 11 13 12 13 10 11 10 4 5 11 3 11 3 10 10 5 12 3 11 3 25 26 26 26 26 26 26 26 26 26
26 26 26 26 26 26 26 26 26 27 10 12 13 2 2 11 5 10 12 4 11 5 13 10 12 12 12 10 13 13 25 26 26 26 26 26 26 26 26 26
26 26 26 26 26 26 26 26 26 27 11 12 10 3 9 5 12 10 5 12 12 13 10 10 12 13 10 11 12 3 25 26 26 26 26 26 26 26 26 26
26 26 26 26 26 26 26 26 26 27 3 3 3 11 13 2 13 2 5 2 13 3 11 2 2 11 5 2 13 11 25 26 26 26 26 26 26 26 26 26
26 26 26 26 26 26 26 26 26 27 5 12 3 5 2 5 2 11 2 13 3 11 5 4 2 3 11 11 13 4 25 26 26 26 26 26 26 26 26 26
26 26 26 26 26 26 26 26 26 27 12 5 12 13 3 12 11 11 2 2 13 2 12 5 5 9 1 13 4 12 25 26 26 26 26 26 26 26 26 26
26 26 26 26 26 26 26 26 26 27 12 11 13 4 13 11 3 3 11 4 4 2 4 11 10 2 5 11 11 11 25 26 26 26 26 26 26 26 26 26
26 26 26 26 26 26 26 26 26 27 11 13 2 3 10 10 3 13 3 11 3 3 12 13 2 3 10 3 3 13 25 26 26 26 26 26 26 26 26 26
26 26 26 26 26 26 26 26 26 27 13 3 3 12 12 12 5 12 12 12 12 13 5 3 2 10 3 3 13 3 25 26 26 26 26 26 26 26 26 26
26 26 26 26 26 26 26 26 26 27 3 10 3 13 12 12 13 10 5 11 13 3 11 10 11 13 3 11 10 5 25 26 26 26 26 26 26 26 26 26
26 26 26 26 26 26 26 26 26 27 10 12 13 3 11 11 10 5 3 2 10 10 13 11 5 10 12 13 10 5 25 26 26 26 26 26 26 26 26 26
26 26 26 26 26 26 26 26 26 27 2 3 12 10 11 12 10 1 11 3 5 13 5 5 3 3 4 13 2 4 25 26 26 26 26 26 26 26 26 26
26 26 26 26 26 26 26 26 26 27 13 2 12 10 5 13 10 10 3 5 2 10 3 2 13 13 11 5 2 11 25 26 26 26 26 26 26 26 26 26
26 26 26 26 26 26 26 26 26 27 12 3 10 11 5 11 11 2 11 12 11 12 12 11 11 10 11 3 10 5 25 26 26 26 26 26 26 26 26 26
26 26 26 26 26 26 26 26 26 27 12 5 12 13 13 3 4 13 4 5 2 12 12 13 12 12 12 12 12 12 25 26 26 26 26 26 26 26 26 26
26 26 26 26 26 26 26 26 26 28 18 18 18 18 18 18 18 18 18 18 18 18 18 18 18 18 18 18 18 18 29 26 26 26 26 26 26 26 26 26
26 26 26 26 26 26 26 26 26 26 26 26 26 26 26 26 26 26 26 26 26 26 26 26 26 26 26 26 26 26 26 26 26 26 26 26 26 26 26 26
26 26 26 26 26 26 26 26 26 26 26 26 26 26 26 26 26 26 26 26 26 26 26 26 26 26 26 26 26 26 26 26 26 26 26 26 26 26 26 26
26 26 26 26 26 26 26 26 26 26 26 26 26 26 26 26 26 26 26 26 26 26 26 26 26 26 26 26 26 26 26 26 26 26 26 26 26 26 26 26
26 26 26 26 26 26 26 26 26 26 26 26 26 26 26 26 26 26 26 26 26 26 26 26 26 26 26 26 26 26 26 26 26 26 26 26 26 26 26 26
26 26 26 26 26 26 26 26 26 26 26 26 26 26 26 26 26 26 26 26 26 26 26 26 26 26 26 26 26 26 26 26 26 26 26 26 26 26 26 26
26 26 26 26 26 26 26 26 26 26 26 26 26 26 26 26 26 26 26 26 26 26 26 26 26 26 26 26 26 26 26 26 26 26 26 26 26 26 26 26
26 26 26 26 26 26 26 26 26 26 26 26 26 26 26 26 26 26 26 26 26 26 26 26 26 26 26 26 26 26 26 26 26 26 26 26 26 26 26 26
26 26 26 26 26 26 26 26 26 26 26 26 26 26 26 26 26 26 26 26 26 26 26 26 26 26 26 26 26 26 26 26 26 26 26 26 26 26 26 26
26 26 26 26 26 26 26 26 26 26 26 26 26 26 26 26 26 26 26 26 26 26 26 26 26 26 26 26 26 26 26 26 26 26 26 26 26 26 26 26