26 26 26 36 36 36 36 36 26 26 26 26 26 26 26 26 26 26 26 26 26 26 26 26 26 26 26 26 26 26 26 26 26 26 26 26 26 26 26 26
26 26 26 36 36 36 36 36 36 36 36 36 26 26 26 26 26 26 36 36 36 36 36 36 36 36 36 36 36 26 26 26 26 26 26 26 26 26 26 26
26 26 26 26 36 36 36 36 36 36 26 36 26 26 26 36 36 36 36 26 26 26 26 26 26 26 26 26 26 26 26 36 36 36 36 26 26 26 26 26
26 26 26 36 36 36 36 36 36 26 26 26 26 26 26 26 26 26 26 26 26 26 26 26 26 26 26 26 26 26 26 26 26 26 26 26 26 26 26 26
26 26 26 26 36 34 34 34 34 34 34 34 34 34 34 34 34 34 34 34 34 34 34 34 34 34 34 34 34 34 34 34 34 34 34 34 26 26 26 26
26 26 26 26 27 97 98 98 98 98 98 98 98 98 98 98 98 98 98 98 98 98 98 98 98 98 98 98 98 98 98 98 98 98 98 99 25 26 26 26
26 26 26 26 27 113 105 106 107 2 2 2 2 2 5 5 2 2 5 5 5 5 5 5 5 5 5 2 2 2 2 2 2 2 2 115 25 26 26 26
26 26 26 26 27 113 121 122 123 100 2 2 2 2 5 5 2 2 2 2 2 2 2 2 2 2 2 2 2 2 2 2 2 2 2 115 25 26 26 26
26 26 26 26 27 113 137 138 139 116 2 2 2 2 5 5 2 2 2 2 2 2 2 2 2 2 2 2 2 2 2 2 2 2 2 115 25 26 26 26
26 26 26 26 27 113 2 2 2 2 2 2 2 2 5 5 2 2 2 2 2 2 2 2 2 2 2 2 2 2 2 2 2 2 2 115 25 26 26 26
26 26 26 26 27 113 2 2 2 2 2 2 2 2 2 2 2 2 2 2 2 2 2 2 2 2 2 2 2 2 2 2 2 2 2 115 25 26 26 26
26 26 26 26 27 113 2 2 2 2 2 2 2 2 2 2 2 2 2 2 2 2 2 2 2 2 2 2 2 2 2 2 2 2 2 115 25 26 26 26
26 26 26 26 27 113 2 2 2 2 2 2 2 2 2 2 2 2 2 2 108 109 2 2 2 5 5 5 5 5 5 5 5 5 2 115 25 26 26 26
26 26 26 26 27 113 2 2 2 2 5 5 5 5 2 2 2 2 2 2 124 125 2 2 2 5 5 5 5 5 5 5 5 5 2 115 25 26 26 26
26 26 26 26 27 113 2 2 2 2 2 2 2 2 2 2 2 2 2 2 2 2 2 2 2 2 2 2 2 2 2 37 5 5 2 115 25 26 26 26
26 26 26 26 27 113 2 2 2 2 2 2 2 2 2 2 2 2 2 2 2 2 2 2 2 2 2 2 2 2 2 2 5 5 2 115 25 26 26 26
26 26 26 26 27 113 2 2 2 2 2 2 2 2 2 2 2 2 2 2 2 2 2 2 2 2 2 2 2 2 2 2 5 5 2 115 25 26 26 26
26 26 26 26 27 113 2 2 2 2 2 2 2 2 2 2 2 2 2 2 2 2 2 2 2 2 2 2 2 2 2 2 5 5 2 115 25 26 26 26
26 26 26 26 27 113 2 2 2 2 2 2 2 2 2 2 2 2 2 2 2 2 2 2 2 2 2 2 2 2 2 2 5 5 2 115 25 26 26 26
26 26 26 26 27 113 5 5 5 5 2 2 2 2 2 2 2 2 2 2 2 2 2 2 2 2 2 2 5 5 5 5 5 5 2 115 25 26 26 36
26 36 36 26 27 113 108 109 2 5 2 2 2 2 2 2 2 2 2 2 2 2 2 2 2 2 2 2 2 2 2 2 5 5 2 115 25 26 26 36
26 36 26 26 27 113 124 125 2 5 2 2 2 2 2 2 2 2 2 2 2 97 98 98 98 99 2 2 2 2 2 2 2 2 2 115 25 26 26 36
26 36 26 26 27 113 60 61 2 5 5 5 5 5 2 2 2 2 5 2 2 113 17 18 19 115 2 2 2 2 2 2 2 2 2 115 25 26 26 36
26 36 26 26 27 113 68 69 2 5 5 5 5 5 2 2 2 2 5 2 2 113 25 26 27 115 2 2 2 2 2 2 2 2 2 115 25 26 26 36
26 36 26 26 27 113 2 2 2 5 2 2 2 5 2 2 2 2 5 2 2 113 25 26 27 115 2 2 2 2 2 2 2 2 2 115 25 26 26 36
26 36 26 26 27 113 2 2 2 5 2 2 2 5 2 2 2 2 5 2 2 113 25 26 27 115 2 2 2 2 2 2 2 2 2 115 25 26 36 36
26 36 26 26 27 113 2 2 2 5 2 2 2 2 2 2 2 2 2 2 2 113 25 26 27 115 2 2 5 2 2 2 5 5 5 115 25 26 36 26
26 36 26 26 27 113 2 2 2 5 2 2 2 2 2 2 2 2 2 2 2 113 33 34 35 115 2 2 5 2 2 2 2 2 2 115 25 26 26 26
26 36 26 26 27 113 2 2 2 2 2 2 2 2 2 2 2 2 2 2 2 129 130 130 130 131 2 2 5 2 2 2 2 2 2 115 25 26 26 26
26 26 26 26 27 113 2 2 2 2 2 2 2 2 2 89 2 2 2 2 2 2 2 2 2 2 2 2 2 2 2 2 2 2 2 115 25 26 26 26
26 26 26 26 27 113 2 2 2 2 2 2 2 2 2 2 2 2 133 133 133 2 2 2 2 2 2 2 2 2 2 2 2 2 2 115 25 26 26 26
26 26 26 26 27 113 2 2 2 2 2 2 2 2 2 2 2 133 133 133 133 2 2 2 2 2 2 2 2 2 2 2 2 2 2 115 25 26 26 26
26 26 26 26 27 113 2 2 2 2 2 2 2 2 2 2 2 2 2 2 2 2 2 2 2 2 2 2 2 2 2 2 2 2 2 115 25 26 26 26
26 26 26 26 27 113 2 2 2 2 2 2 2 2 2 2 2 2 2 2 2 2 2 2 2 2 2 2 2 2 2 2 2 2 2 115 25 26 26 26
26 26 26 26 27 113 2 2 2 2 2 2 2 2 2 2 2 2 2 2 2 2 2 2 2 2 2 2 2 2 2 2 2 2 2 115 25 26 26 26
26 26 26 26 27 129 130 130 130 130 130 130 130 130 130 130 130 130 130 130 130 130 130 130 130 130 130 130 130 130 130 130 130 130 130 131 25 26 26 26
26 26 26 36 36 18 18 18 18 18 18 18 18 18 18 18 18 18 18 18 18 18 18 18 18 18 18 18 18 18 18 18 18 18 18 18 26 26 26 26
26 26 26 26 26 26 26 26 26 26 26 26 26 26 26 26 26 26 26 26 26 26 26 26 36 36 36 26 26 26 26 26 26 26 26 26 26 26 26 26
26 26 26 26 26 26 26 26 26 26 26 26 26 26 26 26 26 26 26 26 36 36 36 36 36 36 26 26 26 26 26 26 26 26 26 26 26 26 26 26
26 26 26 26 26 26 26 26 26 26 26 26 26 26 26 26 26 26 26 26 26 26 26 26 26 26 26 26 26 26 26 26 26 26 26 26 26 26 26 26