60 58 58 58 58 58 58 58 58 58 58 58 58 58 58 58 58 58 58 58 58 58 58 58 58 58 58 58 58 58 58 58 58 58 58 58 58 58 58 61 
51 70 70 70 71 70 70 70 70 70 70 70 70 70 70 70 70 78 78 70 70 70 71 88 70 70 70 70 70 70 70 70 70 70 70 70 70 70 70 49 
51 70 105 106 107 70 70 70 88 70 72 71 70 71 71 71 70 70 70 71 71 70 70 70 71 70 70 70 70 72 70 70 78 72 72 70 70 71 70 49 
51 70 121 122 123 71 70 72 79 71 70 71 70 70 70 72 70 70 70 70 70 70 70 70 70 70 70 88 70 71 78 41 42 42 42 43 70 70 80 49 
51 70 137 138 139 70 70 72 72 71 70 70 70 70 71 70 80 88 70 70 71 70 70 87 70 70 70 70 70 70 71 49 50 60 61 51 70 70 70 49 
51 78 70 70 70 70 70 71 70 70 70 70 70 70 70 70 71 70 70 70 70 71 72 70 70 70 70 78 70 70 70 49 50 68 69 51 70 65 67 49 
51 70 71 70 70 70 70 70 70 70 70 70 70 70 70 70 46 47 47 48 70 70 70 70 70 70 70 70 70 70 70 49 60 61 50 51 72 81 83 49 
51 70 70 70 71 71 70 70 70 71 70 70 70 72 71 70 54 55 55 56 71 70 72 71 70 70 97 98 98 98 99 49 68 69 50 51 70 70 71 49 
51 70 80 70 70 70 71 97 78 70 70 87 71 79 86 71 54 55 55 56 70 70 70 70 78 72 113 102 103 104 115 49 60 61 60 59 70 70 70 49 
51 70 70 70 71 70 88 70 108 109 71 70 70 70 70 70 62 63 63 64 70 78 70 70 70 70 113 118 119 120 115 49 68 69 51 41 42 42 43 49 
51 80 70 80 70 71 70 80 124 125 70 71 70 70 70 72 80 70 70 70 70 70 70 88 71 70 113 134 135 136 116 57 58 58 59 49 60 61 51 49 
51 70 70 71 88 70 78 79 70 71 80 70 79 70 70 70 88 70 70 78 88 70 71 70 70 70 113 102 103 104 102 103 104 100 87 49 51 49 51 49 
51 70 70 70 70 71 70 70 70 70 70 71 71 70 70 70 8 8 8 8 8 78 87 70 70 70 113 118 119 120 118 119 120 115 80 49 68 69 51 49 
51 46 47 48 78 79 88 79 65 66 66 67 70 70 70 70 8 105 106 107 8 71 79 79 70 70 129 134 135 136 134 135 136 116 80 57 58 58 59 49 
51 62 63 64 70 70 78 87 73 74 74 75 71 79 70 70 8 121 122 123 8 70 88 70 70 87 38 39 39 39 39 39 39 40 70 70 70 70 70 49 
51 46 47 48 71 70 70 88 73 74 74 75 70 80 70 70 8 137 138 139 8 70 78 70 70 71 70 70 87 71 71 87 70 70 70 70 70 71 70 49 
51 62 63 64 71 70 70 70 81 82 82 83 70 70 70 80 8 8 8 8 8 70 70 70 71 80 70 70 71 70 70 70 70 70 70 70 70 70 70 49 
51 71 71 70 70 70 70 70 70 70 70 88 70 70 70 71 70 70 71 70 70 72 70 70 70 70 70 70 70 70 88 79 70 70 80 70 71 70 70 49 
51 70 70 70 70 70 70 87 70 80 71 80 70 70 70 70 71 71 70 70 70 70 70 70 70 70 70 79 70 70 71 70 70 71 70 70 78 70 80 49 
51 70 70 70 70 70 70 41 42 42 42 43 87 70 70 78 88 70 70 78 79 70 70 71 70 71 70 70 71 71 70 71 80 70 87 70 70 70 70 49 
51 70 70 71 70 70 70 49 102 103 104 51 87 70 70 87 72 70 72 72 72 72 72 72 22 23 23 23 24 70 70 70 70 87 70 70 70 70 70 49 
51 87 70 70 70 71 70 49 118 119 120 51 79 71 79 70 70 72 72 71 71 78 78 78 30 17 18 19 32 108 109 70 79 71 70 70 70 70 70 49 
51 70 70 70 70 70 80 49 134 135 136 51 71 70 70 71 71 70 72 71 71 79 80 80 30 25 26 27 32 124 125 70 70 70 70 80 70 70 79 49 
51 70 87 80 78 71 70 57 70 80 80 59 70 87 70 70 78 71 72 71 71 80 80 80 30 33 34 35 32 70 70 70 70 70 71 70 70 70 70 49 
51 70 70 71 88 70 78 87 79 70 88 70 79 70 70 70 70 88 72 72 72 72 72 72 38 39 39 39 40 70 71 70 70 71 70 70 70 70 71 49 
51 70 70 70 70 70 70 70 70 71 78 70 70 70 70 70 87 70 70 70 88 70 86 80 80 80 80 80 86 80 78 71 70 70 71 70 70 70 70 49 
51 70 70 70 88 71 72 70 70 70 70 70 70 79 71 70 70 70 70 70 70 71 86 80 80 80 80 80 86 70 70 70 70 71 70 70 70 70 70 49 
51 78 70 97 98 99 70 70 70 80 70 70 70 71 87 70 70 87 87 70 70 70 86 86 86 86 86 86 86 70 88 70 70 70 70 70 70 70 70 49 
51 70 70 113 5 115 70 70 88 70 70 70 70 87 70 79 78 79 70 70 78 70 78 79 70 70 70 70 70 70 108 109 70 70 70 70 70 70 70 49 
51 71 78 129 130 131 70 79 72 70 70 70 70 70 70 78 70 70 70 70 70 70 70 70 70 70 71 71 70 71 124 125 70 70 70 70 80 70 70 49 
51 70 70 70 70 78 70 70 70 79 70 70 70 70 80 70 70 70 70 70 78 88 88 78 70 80 70 78 87 70 70 70 72 70 70 70 70 70 71 49 
51 70 70 70 70 71 70 70 70 79 70 71 70 70 71 70 71 70 70 70 80 70 70 71 70 70 70 70 70 70 70 70 70 70 71 71 80 72 79 49 
51 71 70 71 70 78 70 70 71 72 71 80 70 70 70 88 70 72 70 70 70 78 70 70 70 70 70 70 71 70 80 71 70 71 70 70 70 70 88 49 
51 87 79 70 71 70 70 70 78 70 70 86 87 86 70 70 70 70 70 70 70 71 70 71 70 70 80 70 70 71 70 70 70 71 70 70 71 70 79 49 
51 70 70 70 70 70 70 70 70 70 71 70 70 70 70 72 97 98 98 98 98 98 98 98 98 99 71 70 70 70 71 70 71 70 70 70 70 70 70 49 
51 70 72 70 71 70 71 78 70 70 71 70 70 70 70 70 113 105 106 107 101 105 106 107 101 115 71 70 71 70 72 70 71 70 70 70 70 70 70 49 
51 71 78 80 71 70 70 87 71 71 72 70 80 70 70 71 113 121 122 123 4 121 122 123 2 115 70 80 70 70 70 80 78 71 88 70 80 70 70 49 
51 79 71 70 70 70 70 70 70 70 70 70 88 70 70 70 113 137 138 139 4 137 138 139 2 115 70 78 71 71 79 70 70 70 71 70 70 70 71 49 
51 70 70 70 70 71 71 70 80 87 72 70 71 70 70 72 129 132 39 39 39 39 39 39 39 116 70 70 72 70 87 70 70 70 70 71 70 70 70 49 
68 42 42 42 42 42 42 42 42 42 42 42 42 42 42 42 42 42 42 42 42 42 42 42 42 42 42 42 42 42 42 42 42 42 42 42 42 42 42 69