67 87 31 31 31 87 31 31 31 31 88 31 31 81 82 83 87 81 82 83 31 78 78 57 58 58 58 58 58 58 58 58 58 58 58 58 59 31 31 31
75 31 87 88 31 31 31 31 50 50 31 88 88 31 31 31 31 31 31 31 86 78 78 31 31 31 31 31 31 31 71 71 71 71 71 31 31 78 78 78
75 31 87 31 50 50 50 50 50 31 22 23 23 23 24 31 31 31 87 31 31 78 78 31 31 31 86 31 31 31 71 71 71 71 71 31 31 31 31 65
75 31 31 31 31 31 31 86 31 31 30 5 5 5 32 31 50 31 31 31 31 87 31 31 31 31 31 31 22 23 23 23 23 23 23 23 23 23 24 73
83 31 31 76 77 31 31 31 31 31 30 105 106 101 32 31 50 50 50 31 31 31 31 31 88 88 88 88 30 133 2 5 5 5 5 91 91 91 32 73
87 31 31 84 85 31 80 80 31 31 30 121 122 123 32 22 23 23 23 24 72 31 41 42 43 88 88 88 30 133 3 89 17 18 18 19 37 100 32 73
43 31 31 31 31 31 31 50 50 31 30 137 138 139 32 30 5 17 19 32 72 31 49 50 51 31 31 88 30 96 108 109 33 34 34 35 37 115 32 73
51 31 31 31 31 80 31 50 31 31 30 91 91 96 32 30 96 33 35 32 72 31 49 50 51 87 31 71 30 96 124 125 96 96 96 96 100 115 32 73
51 31 31 31 80 31 31 50 31 88 30 114 130 132 32 38 39 39 39 40 31 31 49 50 51 31 31 71 30 1 1 94 94 94 93 93 115 131 32 73
51 31 87 31 31 31 31 50 31 88 38 39 39 39 40 50 31 88 88 31 31 31 57 58 59 31 31 31 30 1 5 93 93 93 94 94 115 90 32 73
51 31 31 31 31 31 31 31 31 71 71 71 71 31 50 50 31 31 31 31 86 31 31 87 31 31 31 31 30 1 5 90 114 130 130 130 131 90 32 73
59 31 31 31 31 31 31 31 31 31 31 31 31 31 31 31 46 47 47 48 31 31 31 31 31 31 31 31 38 39 39 39 39 39 39 39 39 39 40 73
67 31 50 31 80 31 72 31 31 31 87 31 87 31 31 31 62 63 63 64 31 31 31 31 50 31 31 71 71 71 71 31 31 31 31 88 88 88 31 73
75 31 50 31 72 72 72 31 72 31 31 31 31 31 87 31 65 66 66 66 67 87 31 31 50 31 31 71 71 71 71 31 31 31 31 31 46 47 48 73
75 31 50 31 31 80 31 31 72 31 31 31 72 31 31 31 81 82 82 82 83 31 31 31 50 31 46 47 47 47 48 31 31 31 31 86 54 55 56 73
83 31 50 31 31 31 31 31 72 31 31 31 72 31 31 31 31 31 31 31 31 31 31 78 78 31 62 63 63 63 64 50 50 50 31 31 62 63 64 73
80 31 50 31 88 31 31 31 31 31 87 31 46 47 48 78 78 31 31 31 31 31 31 31 31 31 31 31 31 31 31 31 31 31 46 47 47 48 31 73
67 31 31 31 31 31 72 31 31 87 31 31 54 55 56 31 78 31 31 31 72 80 31 31 31 31 31 78 78 31 31 31 31 31 54 55 55 56 31 73
75 31 87 31 87 31 31 31 87 31 31 86 54 55 56 31 31 31 72 72 31 80 31 31 80 31 31 78 78 31 31 80 31 31 54 55 55 56 31 73
75 80 31 31 31 31 50 31 31 31 31 31 62 63 64 31 72 72 72 31 31 31 31 31 31 31 31 31 31 31 31 31 80 80 62 63 63 64 31 73
75 31 31 72 31 31 50 50 50 50 31 71 22 23 23 23 23 23 24 31 31 31 72 72 31 31 31 31 31 31 31 31 80 31 80 31 31 80 31 73
75 72 72 72 31 31 31 31 31 31 31 71 30 5 102 103 104 90 32 31 31 72 72 31 46 47 47 47 48 31 31 31 31 31 31 31 31 31 31 73
75 31 31 78 31 31 31 87 31 31 31 71 30 5 118 119 120 96 32 31 31 72 31 31 54 55 55 55 56 50 50 50 50 31 31 31 31 31 31 81
83 88 31 31 31 31 31 31 46 47 48 71 30 101 134 135 136 96 32 31 71 71 71 31 54 55 55 55 56 31 31 31 31 31 31 31 72 31 31 88
43 31 78 72 72 72 72 31 54 55 56 71 38 39 39 39 39 39 40 31 71 71 71 31 62 63 63 63 64 31 71 71 71 31 31 31 72 31 80 65
51 31 31 31 31 31 31 31 54 55 56 31 31 31 31 50 31 22 23 23 24 31 31 31 31 50 31 31 78 78 87 87 31 31 31 72 72 87 87 73
51 31 31 31 31 31 31 31 62 63 64 31 31 71 71 50 31 30 17 19 32 88 31 31 50 50 31 31 78 78 31 31 31 72 72 72 31 71 71 73
51 31 78 72 31 31 31 50 50 50 31 31 31 71 71 50 31 30 33 35 32 88 31 31 50 31 31 31 31 31 31 31 71 71 31 22 23 23 24 73
51 31 31 72 31 31 31 31 31 31 31 31 31 31 31 31 31 38 39 39 40 31 31 50 50 31 31 31 31 31 31 31 31 31 86 30 37 37 32 73
59 31 31 72 72 31 31 31 87 31 31 72 31 31 31 31 31 31 31 31 31 31 31 50 31 31 78 78 31 31 31 71 31 31 31 38 39 39 40 73
43 31 31 31 31 31 31 31 31 31 31 72 31 31 72 72 72 72 72 31 31 86 31 31 31 31 78 78 31 31 87 71 31 22 23 23 23 23 24 73
51 31 88 31 72 72 31 87 31 31 31 31 31 31 31 31 31 31 31 31 31 31 31 31 88 31 31 31 31 31 87 71 31 30 17 18 18 19 32 73
51 31 31 72 72 31 31 31 31 78 78 78 31 31 31 31 78 31 31 31 31 31 31 31 31 31 31 31 31 31 87 71 31 30 33 34 34 35 32 73
51 31 31 72 31 31 31 87 31 31 31 78 31 31 31 78 78 31 31 50 31 31 31 31 72 72 72 72 31 31 31 31 31 38 39 39 39 39 40 73
51 31 72 72 31 31 31 31 31 31 31 31 31 31 31 31 87 31 31 50 31 65 66 66 66 67 31 31 31 31 31 31 31 31 31 31 31 31 31 73
51 31 31 31 31 72 31 31 31 50 50 50 50 31 31 31 87 31 31 50 31 73 74 74 74 75 31 31 31 31 31 86 31 31 71 71 71 71 31 73
51 87 31 87 31 72 31 46 47 47 47 47 48 31 31 31 31 31 31 50 31 73 74 74 74 75 78 78 31 46 47 47 48 31 31 31 31 31 31 81
51 87 31 87 31 31 31 62 63 63 63 63 64 31 78 78 31 31 31 31 31 81 82 82 82 83 31 78 31 62 63 63 64 72 72 72 71 71 71 31
51 31 87 87 31 31 31 72 72 72 72 72 31 31 78 80 31 76 77 31 88 31 72 72 72 72 31 31 31 31 31 31 72 72 31 31 87 87 87 31
68 42 42 42 42 42 42 42 42 42 42 42 42 42 42 42 43 84 85 41 42 42 42 42 42 42 42 42 43 80 80 86 31 31 31 31 31 31 31 31
