36 36 36 36 36 26 36 36 36 36 36 26 26 26 26 26 36 36 26 36 36 20 21 26 26 20 34 34 34 34 34 21 20 34 34 34 34 34 21 26
36 36 36 26 36 20 34 34 34 34 34 34 34 34 34 21 36 36 26 36 36 28 29 36 20 35 1 4 2 3 3 25 27 1 1 1 2 1 25 36
36 20 21 26 36 27 1 2 3 1 2 133 133 133 1 33 21 26 26 26 26 26 36 36 27 2 4 4 133 133 2 25 27 1 2 3 133 3 25 36
26 28 29 36 26 28 19 37 1 2 3 1 2 3 1 1 33 21 20 34 21 26 36 26 27 1 1 1 1 2 1 25 27 2 3 3 133 3 25 36
26 36 26 26 36 26 27 37 1 2 3 89 6 7 92 2 1 33 35 92 25 26 36 36 27 3 3 3 2 3 3 25 27 3 1 3 133 1 25 36
36 26 26 26 36 36 27 101 101 101 2 2 14 15 1 92 2 1 2 92 25 26 26 36 27 1 2 1 17 18 18 29 27 3 3 2 2 1 25 26
26 20 21 36 26 36 28 18 18 19 1 1 2 3 3 1 1 1 2 37 25 26 26 26 27 2 2 3 25 20 34 34 35 2 3 1 2 2 25 36
36 28 29 36 26 36 20 21 36 27 91 105 106 107 1 100 1 1 2 37 25 26 36 36 27 3 3 2 25 27 2 1 2 3 3 3 2 17 29 36
36 36 26 26 36 36 28 29 26 27 91 121 122 123 1 115 1 1 2 1 25 36 36 26 28 19 1 2 33 35 2 3 17 18 18 18 18 29 26 36
26 26 20 34 34 21 26 36 36 27 91 137 138 139 1 115 1 1 2 1 25 26 26 36 26 28 19 3 1 2 1 2 25 20 34 34 21 26 36 36
36 26 27 2 2 25 36 36 36 27 91 1 2 3 1 115 1 2 17 18 29 26 26 36 26 36 28 19 1 3 2 17 29 27 1 37 25 26 26 36
20 34 35 133 133 33 21 26 36 27 114 130 130 130 130 131 1 2 25 36 26 26 36 20 21 26 36 27 1 2 1 25 20 35 3 37 33 34 34 21
27 1 133 1 92 2 25 36 20 35 1 2 2 1 1 1 1 17 29 36 26 26 26 28 29 26 26 27 1 2 17 29 27 4 4 4 2 3 2 25
27 1 133 1 92 2 25 20 35 1 2 3 1 17 19 2 2 25 26 36 26 26 26 36 26 36 36 27 1 2 25 36 28 18 18 18 18 19 1 25
27 1 133 1 92 3 25 27 1 1 2 1 1 25 27 1 2 25 26 36 36 26 26 26 36 36 36 27 1 2 25 26 26 36 36 36 36 27 1 25
27 1 3 1 92 2 25 27 1 17 19 1 1 25 27 1 2 33 34 34 34 34 21 36 26 20 21 27 1 2 25 26 26 26 26 26 36 27 2 25
28 18 19 1 1 2 25 27 1 25 27 2 17 29 27 1 1 2 5 5 2 92 25 26 26 28 29 27 1 2 33 34 34 34 34 21 26 27 2 25
36 36 27 1 1 3 25 27 1 25 28 18 29 26 28 19 1 2 3 1 1 92 25 26 26 36 26 27 1 2 2 4 3 2 133 33 21 27 3 25
36 26 27 1 1 3 33 35 1 33 34 34 34 34 21 27 1 2 6 7 4 4 33 34 34 34 34 35 1 2 2 3 2 1 3 133 25 27 1 25
26 26 27 1 1 2 1 2 1 1 1 1 1 1 25 27 5 3 14 15 2 37 1 1 2 1 2 1 2 17 18 18 18 18 18 18 29 27 3 25
26 26 27 1 1 2 1 1 17 18 18 18 18 18 29 27 5 1 3 3 4 37 1 1 2 1 6 7 2 33 34 34 34 34 34 34 21 27 1 25
36 36 28 19 1 1 1 1 25 36 26 26 36 26 36 27 5 3 6 7 2 37 1 1 2 1 14 15 2 1 2 1 2 1 2 1 25 27 1 25
26 36 26 28 19 1 1 1 25 36 26 36 26 36 26 27 5 1 14 15 4 1 2 1 17 18 18 18 18 18 18 18 18 18 19 4 25 27 2 25
36 36 36 36 28 18 18 18 29 36 36 36 26 36 26 27 37 3 3 3 3 1 2 1 33 34 34 21 36 36 36 36 26 36 27 3 25 27 2 25
36 36 36 36 26 26 26 26 36 36 36 26 26 26 36 27 37 93 94 1 3 102 103 104 114 100 1 25 26 36 36 36 36 26 27 3 25 27 3 25
36 26 26 36 20 34 34 34 34 34 34 34 34 34 34 35 3 1 94 5 5 118 119 120 91 116 3 25 36 26 26 36 36 36 27 3 25 27 3 25
26 26 26 36 27 133 3 37 37 37 2 1 5 92 92 92 1 1 94 93 94 134 135 136 91 116 3 25 36 26 36 26 36 26 27 3 25 27 3 25
26 26 26 36 27 5 2 3 2 1 3 1 3 3 1 3 1 1 94 93 94 102 103 104 91 116 2 33 34 34 34 34 34 34 35 1 33 35 2 25
26 36 26 26 27 5 1 1 6 7 1 3 3 2 1 3 2 1 94 89 93 118 119 120 91 116 3 2 3 2 1 37 37 37 4 6 7 1 2 25
36 36 26 36 27 5 5 3 14 15 2 3 5 5 5 5 1 2 94 1 1 134 135 136 114 131 2 17 18 19 3 3 1 2 1 14 15 1 1 25
26 26 36 26 27 133 5 2 3 2 3 17 18 18 18 19 1 5 5 1 1 93 94 1 100 17 18 29 26 27 3 2 3 3 133 4 133 133 133 25
20 21 36 36 27 2 5 5 5 3 1 25 36 36 26 27 1 2 1 2 1 1 2 4 115 25 26 26 26 27 2 1 1 5 17 18 18 18 18 29
28 29 36 26 28 18 18 18 18 18 18 29 26 26 26 27 37 37 1 2 114 130 130 130 131 25 26 26 36 27 1 2 3 5 25 36 36 36 36 26
26 26 36 36 20 34 34 34 34 21 36 26 26 26 26 27 3 1 1 1 2 91 37 2 3 25 20 34 34 35 3 3 3 133 25 26 26 26 36 26
36 26 20 21 27 2 1 2 1 25 36 26 20 21 36 28 18 19 1 1 2 91 37 133 133 25 27 2 89 3 2 2 1 1 25 26 36 26 36 36
26 36 28 29 27 2 5 5 5 25 36 26 28 29 36 36 26 27 5 2 3 3 3 1 17 29 27 2 2 3 3 1 2 37 25 26 36 36 26 26
36 26 26 20 35 91 91 91 91 25 36 36 26 36 36 26 26 27 5 1 3 1 2 17 29 36 28 19 2 108 109 3 1 37 25 36 36 26 26 36
26 36 36 27 37 1 1 1 1 33 34 34 34 34 34 34 34 35 1 1 1 91 17 29 26 26 36 27 133 124 125 1 2 37 25 36 36 26 36 26
36 26 26 27 37 37 37 91 1 1 1 1 1 1 1 1 1 1 1 1 1 1 25 36 26 26 36 27 133 3 2 3 1 5 25 26 26 36 36 36
26 36 26 28 18 18 18 18 18 18 18 18 18 18 18 18 18 18 18 18 18 18 29 36 26 26 36 28 18 18 18 18 18 18 29 26 36 36 26 26
