60 58 58 58 58 59 81 82 82 82 82 83 31 31 31 31 31 81 82 83 49 50 50 50 51 31 31 31 71 71 71 80 31 80 57 58 58 58 58 58
51 31 72 31 65 67 31 31 31 31 31 31 31 79 79 79 79 31 46 48 57 58 58 61 68 43 71 71 31 31 31 80 80 31 31 31 71 31 31 31
59 31 31 31 81 83 31 31 31 80 31 31 31 31 31 31 31 31 62 64 31 31 31 57 58 59 31 31 31 31 31 31 31 31 31 31 31 71 31 31
66 67 31 31 31 31 31 31 31 80 65 67 31 31 31 71 71 31 31 31 31 31 31 31 31 31 31 31 31 31 31 31 66 66 31 31 31 31 71 31
74 84 67 31 31 31 79 31 31 80 73 75 31 31 71 31 31 31 31 72 31 41 42 42 43 31 41 42 42 42 43 65 77 76 67 31 31 31 31 71
74 74 75 31 41 43 79 31 31 31 73 75 31 31 31 65 66 66 67 31 31 49 60 61 51 31 49 60 31 61 51 73 82 82 75 31 31 31 31 79
82 82 83 31 57 59 31 31 31 31 81 83 31 31 31 81 82 82 83 31 31 49 68 69 51 31 49 68 31 69 51 73 31 31 75 31 71 79 79 79
66 67 31 46 47 47 47 48 31 31 72 31 31 31 31 80 80 31 31 31 31 57 58 58 59 31 57 58 58 58 59 73 66 66 75 71 31 31 31 31
74 75 31 54 55 55 55 56 31 65 66 66 67 31 80 31 31 31 72 31 79 79 79 31 31 31 31 31 31 31 31 81 85 84 83 71 31 31 31 31
74 75 31 62 63 63 63 64 31 73 74 74 75 31 31 31 31 31 72 31 31 31 31 31 41 42 42 43 31 31 31 31 82 82 31 41 42 42 43 31
74 75 31 31 41 43 31 31 31 73 74 74 75 31 31 31 31 31 31 31 31 31 31 31 57 58 58 59 31 79 79 79 79 31 31 57 58 58 59 80
74 75 72 31 49 51 31 79 31 73 74 74 75 31 71 79 31 31 31 31 72 72 46 48 31 88 88 31 41 43 31 31 31 31 72 31 31 31 31 80
74 75 31 31 49 51 31 79 31 81 82 82 83 31 71 79 79 31 31 72 72 31 54 56 31 88 31 31 57 59 31 31 72 72 31 65 66 67 88 31
82 83 31 31 49 51 31 79 79 31 87 87 31 31 71 31 79 31 31 31 31 31 62 64 31 31 31 31 88 88 31 31 31 31 31 73 74 75 31 31
72 72 31 31 49 51 31 31 79 88 31 46 47 48 31 31 31 31 31 31 31 65 66 66 66 66 67 31 31 41 42 42 43 31 31 73 74 75 88 80
31 72 31 31 57 59 31 31 88 88 31 54 55 56 31 31 31 31 31 31 31 73 74 74 74 74 75 31 31 57 58 58 59 65 66 85 76 83 31 80
42 43 72 31 31 31 75 31 88 88 31 54 55 56 41 42 42 42 43 31 31 81 82 82 82 82 83 31 31 31 65 66 67 73 74 74 75 31 31 80
50 51 31 31 31 31 75 46 47 47 48 54 55 56 49 50 50 50 51 31 31 31 31 31 79 79 79 31 31 31 73 74 75 81 82 82 83 31 31 88
58 59 31 31 31 31 31 54 55 55 56 54 55 56 57 58 58 58 59 31 31 31 31 31 31 31 31 31 31 31 73 74 83 31 71 31 31 31 80 31
72 31 31 31 65 67 31 54 55 55 56 54 55 56 31 31 31 31 31 31 31 41 42 42 43 31 46 48 31 31 81 82 83 31 71 31 31 31 80 31
31 72 31 31 73 75 31 62 63 63 64 62 63 64 65 66 67 71 71 31 31 49 50 50 68 43 62 64 47 47 31 31 31 71 31 31 31 31 80 31
31 72 72 31 73 75 31 31 31 31 31 31 31 31 73 74 75 71 31 31 31 49 50 50 50 51 31 31 45 44 41 43 41 43 71 31 31 31 65 66
72 31 31 31 73 75 31 31 65 66 66 67 79 79 73 74 75 31 31 31 31 57 58 58 58 59 31 31 53 52 49 68 69 51 79 31 31 31 73 74
67 31 31 31 73 75 31 31 81 82 82 83 31 31 81 82 83 31 31 31 31 31 65 66 66 67 46 48 63 63 57 58 58 59 79 79 31 31 73 74
75 31 72 31 81 83 31 31 31 31 31 31 31 46 47 47 48 31 80 80 31 31 81 82 82 83 62 64 31 31 46 47 47 48 31 79 31 65 74 74
75 31 31 31 31 31 31 31 72 72 72 88 88 54 55 55 56 80 80 31 31 31 79 79 31 41 43 31 31 31 54 55 55 56 31 79 31 81 82 82
75 31 31 31 31 72 31 31 72 31 88 88 31 62 63 63 64 31 31 31 31 31 31 31 31 49 51 31 65 67 54 55 55 56 31 31 31 31 88 41
75 31 31 31 31 31 31 41 42 43 31 31 31 31 65 66 66 66 67 31 31 31 46 47 48 49 51 31 73 75 62 63 63 64 31 31 65 67 88 49
83 31 72 31 31 31 31 57 58 59 31 31 31 31 81 82 77 74 84 66 66 67 54 55 56 57 59 31 73 75 31 31 31 31 31 31 73 75 88 49
31 31 72 31 65 67 31 31 31 31 31 31 31 31 31 31 81 82 82 82 82 83 54 55 56 31 31 31 81 83 31 31 31 71 71 31 81 83 88 49
31 72 31 31 81 83 31 41 43 80 80 80 31 31 46 47 47 47 48 71 31 31 54 55 56 31 31 31 31 31 31 31 31 31 31 31 31 31 31 49
31 72 31 31 31 31 31 49 51 88 88 88 31 31 54 55 55 55 56 71 31 31 62 63 64 31 41 42 42 43 31 46 48 31 82 82 31 31 79 49
31 72 31 31 31 31 31 57 59 31 31 31 31 31 54 55 55 55 56 71 71 31 31 71 31 31 57 58 58 59 31 62 64 31 66 66 71 31 79 49
31 31 72 72 31 31 31 31 31 31 65 66 66 66 67 63 63 63 64 31 73 75 31 31 88 88 88 31 31 31 65 67 31 31 88 88 88 31 31 49
31 31 31 31 41 43 31 31 41 43 73 74 74 74 75 31 79 79 79 31 73 75 31 31 31 31 31 31 31 73 76 77 75 31 31 31 31 31 31 49
67 31 31 31 57 59 31 31 57 59 73 74 74 74 75 31 31 31 31 31 31 31 41 42 42 42 43 31 31 31 84 85 31 31 31 71 71 31 31 57
84 67 72 72 72 31 31 31 31 31 73 74 74 74 75 31 31 46 47 47 48 31 57 58 58 58 59 31 31 31 31 31 31 31 31 42 42 31 31 65
74 75 31 31 31 72 72 72 31 31 81 82 82 82 83 31 31 62 63 63 64 31 31 31 31 71 71 71 31 71 71 71 71 31 31 58 58 31 31 73
74 75 65 67 31 31 31 31 31 31 31 31 31 31 31 31 31 31 31 79 79 79 79 31 31 31 31 31 31 42 42 42 31 31 65 66 67 31 31 73
74 84 85 84 66 66 67 86 79 65 66 67 72 72 72 72 41 42 42 42 42 42 42 43 72 72 72 65 42 42 58 58 67 79 81 82 83 79 79 81
