26 26 36 26 36 26 36 26 36 36 36 36 36 36 36 36 36 36 26 26 26 26 36 36 26 26 26 36 26 26 36 36 26 26 36 36 26 36 26 36
26 26 26 36 26 36 36 36 26 36 26 36 26 26 36 26 36 36 36 36 26 36 36 26 26 36 36 26 26 26 36 36 26 36 26 26 36 26 36 36
26 26 36 26 26 26 26 26 36 26 36 36 36 26 26 26 36 36 26 36 26 26 36 36 26 36 36 26 36 36 26 26 26 26 26 26 26 26 36 36
26 26 36 36 26 36 36 26 36 36 36 26 36 36 26 36 26 26 26 36 26 26 26 26 36 26 36 26 26 36 36 36 26 26 26 26 26 36 26 36
36 26 36 26 36 26 36 26 26 36 36 26 26 26 36 26 26 36 26 36 26 36 36 36 36 26 36 36 26 36 36 36 26 26 26 36 26 26 36 26
36 26 26 36 26 26 36 36 26 36 36 26 26 36 36 26 36 36 26 36 26 36 26 26 26 36 36 36 26 26 26 36 36 36 26 36 26 36 36 36
36 36 26 36 26 26 26 26 26 36 26 26 26 26 36 26 26 26 26 36 36 36 26 36 36 26 36 36 36 26 26 36 26 26 26 36 36 36 26 26
36 36 36 36 26 36 36 26 36 26 36 26 26 36 36 36 36 26 26 36 26 26 26 36 36 26 36 26 36 26 26 36 36 26 36 26 36 26 36 36
36 36 36 36 36 36 36 36 36 26 26 36 26 26 36 36 36 26 26 36 36 36 26 36 26 36 36 36 26 36 36 26 26 26 26 36 26 36 26 26
26 36 26 26 36 36 36 36 36 20 34 34 34 34 34 34 34 34 34 34 34 34 34 34 34 34 34 34 34 34 21 36 36 36 36 36 26 26 26 36
26 26 36 36 26 36 26 36 26 27 2 9 10 5 5 2 1 9 12 4 5 9 9 4 5 1 2 13 5 3 25 26 26 36 36 36 36 26 36 26
36 26 36 26 36 36 36 26 26 27 12 13 5 5 4 1 12 5 5 1 3 13 1 5 12 10 5 3 12 2 25 26 36 36 26 36 36 26 26 26
26 36 36 36 36 26 26 26 26 27 12 5 2 10 13 2 2 10 10 10 10 10 10 10 10 10 10 4 12 9 25 36 26 26 26 36 36 36 36 26
26 36 26 26 26 26 26 26 26 27 13 5 13 2 12 2 11 10 10 10 10 10 10 10 10 10 10 9 4 9 25 36 26 26 36 26 36 26 26 36
36 36 26 36 36 26 36 26 36 27 10 12 4 2 10 1 1 3 2 3 1 5 2 3 3 12 11 13 11 2 25 26 36 26 26 36 26 36 36 36
26 26 26 36 36 26 26 26 26 27 1 3 11 13 10 1 2 3 1 1 5 5 2 3 1 2 4 4 1 12 25 26 26 36 36 26 26 36 26 26
36 36 36 26 36 36 26 26 36 27 4 13 1 12 4 2 1 3 2 5 3 5 2 2 3 11 5 9 11 4 25 26 26 26 36 26 26 36 26 36
36 26 26 36 36 36 26 26 26 27 2 1 1 4 2 1 1 1 5 2 1 5 3 3 3 1 10 5 4 4 25 36 26 26 26 36 36 26 26 26
26 26 26 26 36 36 36 36 26 27 13 12 1 5 2 2 2 5 2 3 1 5 1 2 2 11 2 9 13 4 25 26 26 26 26 36 26 36 26 36
36 36 26 26 36 36 26 26 36 27 12 10 10 1 11 1 5 5 5 5 5 5 5 5 3 11 1 5 3 11 25 36 26 26 36 36 36 36 36 26
36 36 36 26 26 26 36 26 26 27 1 13 5 10 13 2 2 2 2 2 3 5 2 2 3 10 1 2 9 3 25 26 26 36 26 36 36 26 26 26
36 36 36 36 36 36 26 26 26 27 3 13 12 5 9 1 1 2 1 3 3 5 1 2 3 13 5 9 4 13 25 36 26 36 26 26 36 26 26 26
36 36 36 36 26 26 26 26 26 27 12 4 4 1 1 2 2 2 2 1 3 5 1 1 2 5 12 2 10 9 25 26 26 26 26 26 36 26 36 36
26 36 36 26 36 26 36 26 36 27 13 1 5 1 3 1 2 3 1 1 3 10 1 2 3 9 3 1 2 5 25 36 36 26 26 26 36 36 36 36
26 26 36 36 36 26 26 36 26 27 3 3 5 13 3 1 3 2 3 3 1 1 1 1 3 9 9 2 12 3 25 26 36 26 36 26 36 26 26 26
26 26 26 36 26 36 36 36 36 27 9 4 3 12 2 4 10 1 4 5 10 11 5 13 10 13 11 2 11 2 25 26 36 36 26 36 36 36 36 26
26 36 36 36 26 36 36 26 26 27 10 12 11 1 10 10 5 11 2 3 1 3 13 1 13 3 3 5 3 5 25 36 36 26 36 36 36 36 26 36
26 26 26 26 26 36 36 36 26 27 3 10 1 4 1 13 4 1 2 13 12 4 13 2 11 11 3 5 10 10 25 36 36 26 36 26 26 26 36 26
26 36 26 36 36 36 36 36 36 27 10 13 1 12 1 12 2 3 3 9 1 4 12 11 5 2 9 9 1 10 25 36 36 36 36 26 26 36 36 26
26 26 26 36 26 36 36 36 36 27 4 4 10 5 2 3 1 4 10 5 4 11 9 10 5 9 11 13 2 1 25 36 36 26 26 36 26 26 26 36
26 36 26 26 36 36 26 36 36 28 18 18 18 18 18 18 18 18 18 18 18 18 18 18 18 18 18 18 18 18 29 26 26 36 36 26 26 26 36 26
36 26 26 36 26 26 26 36 26 36 36 26 36 36 26 26 26 36 26 26 26 26 36 36 36 36 26 36 36 26 36 26 36 36 36 36 36 36 36 26
36 26 36 36 26 26 26 36 26 26 36 36 36 26 36 26 36 36 26 26 26 36 36 36 36 26 26 26 36 26 26 36 36 26 36 36 36 36 36 36
36 26 26 36 36 26 36 26 26 36 26 36 36 26 26 26 36 26 26 26 26 26 26 26 36 36 26 26 26 26 26 36 26 36 26 36 26 26 36 26
26 26 26 36 26 36 36 26 36 26 36 36 26 36 36 36 26 26 26 36 26 36 36 36 36 36 26 26 36 26 26 36 26 26 26 26 36 26 36 36
26 26 36 26 26 36 26 26 36 26 26 26 26 26 26 36 36 26 26 36 36 26 36 26 26 36 26 26 36 36 26 36 36 26 26 26 36 26 26 26
26 36 26 26 36 36 36 26 26 26 36 36 26 26 36 36 26 36 26 26 36 36 26 36 36 26 36 26 36 26 26 36 26 26 26 36 26 26 26 36
26 36 36 36 36 26 26 26 36 36 36 26 36 36 36 26 26 26 26 36 26 26 36 36 26 26 36 26 26 26 36 36 36 26 26 26 36 36 36 26
26 36 36 36 36 26 36 36 36 36 26 36 26 36 36 26 26 26 26 36 26 26 36 26 36 26 36 26 26 36 26 36 26 36 36 36 26 26 26 26
36 26 26 26 26 36 26 36 26 26 36 26 26 26 26 36 26 36 36 36 26 36 26 26 26 36 26 26 26 26 26 36 26 36 36 26 26 26 26 36
