5 5 5 5 5 5 5 5 5 5 5 5 5 5 5 5 5 5 5 5 5 5 5 5 5 5 5 5 5 5 5 5 5 5 5 5 5 5 5 5
5 2 94 2 105 106 107 1 1 2 105 106 107 1 2 1 105 106 107 94 94 93 94 94 2 94 2 90 90 1 95 1 93 94 1 4 90 90 2 93
5 2 93 3 121 122 123 1 94 4 121 122 123 1 4 3 121 122 123 1 2 90 90 93 94 93 90 90 4 2 95 2 95 2 95 94 95 2 95 2
5 1 4 133 137 138 139 3 1 133 137 138 139 3 1 133 137 138 139 93 94 94 1 1 1 17 18 19 94 5 3 37 93 37 4 37 93 37 2 37
5 3 93 1 94 1 94 2 93 94 1 94 2 2 2 1 1 1 2 94 1 94 1 93 1 25 26 27 1 5 94 93 2 3 93 3 2 94 94 4
5 108 109 93 108 109 94 108 109 1 108 109 2 108 109 2 108 109 93 94 92 3 92 1 2 25 36 27 94 5 1 37 3 37 3 37 4 37 93 37
5 124 125 93 124 125 1 124 125 1 124 125 93 124 125 94 124 125 94 2 2 92 92 1 93 25 26 27 93 5 4 3 2 2 93 93 4 2 93 4
5 5 94 93 1 93 2 1 1 93 94 1 94 93 2 2 2 94 94 94 1 93 2 1 1 25 36 27 93 5 93 37 1 37 4 37 2 37 94 37
5 5 3 89 97 98 98 98 98 98 98 98 98 98 98 99 4 3 2 2 1 94 2 94 1 25 36 27 2 5 2 4 1 94 2 4 2 4 94 1
5 5 2 2 113 96 96 96 96 96 96 96 96 96 96 115 4 102 103 104 2 2 94 93 92 33 34 35 94 5 1 37 1 37 1 37 94 37 1 37
5 5 4 3 113 91 91 91 91 91 91 91 91 91 91 115 4 118 119 120 93 90 4 2 1 4 4 4 2 1 89 1 89 1 89 93 89 3 89 93
5 5 3 4 129 130 130 130 130 130 130 130 130 130 130 131 2 134 135 136 1 94 4 4 4 4 92 92 1 4 4 3 1 2 94 94 92 92 3 5
5 5 1 1 94 1 1 94 93 1 2 93 1 2 1 2 1 93 5 5 5 93 2 2 92 1 2 2 2 1 101 4 2 94 93 92 92 92 3 5
5 5 1 93 93 93 17 18 18 18 18 18 18 19 1 1 94 94 5 5 5 92 4 3 92 3 1 1 92 4 101 4 2 94 1 1 3 2 3 5
5 5 2 2 1 94 25 26 36 36 26 26 36 27 1 93 2 3 5 5 5 1 3 2 2 2 1 4 1 3 101 4 1 92 4 1 90 90 93 5
5 5 2 1 2 94 33 34 34 34 34 34 34 35 93 93 94 1 1 4 1 94 3 2 92 3 101 101 1 2 94 93 93 90 90 1 94 90 4 5
5 5 2 94 1 2 2 94 2 93 94 94 1 94 94 93 2 3 3 4 2 1 3 3 93 93 93 101 101 94 94 93 93 1 90 90 4 3 2 5
5 5 94 89 97 98 98 98 98 98 98 98 98 98 98 99 1 3 93 93 1 3 2 93 93 94 93 2 101 3 2 3 4 5 5 90 90 3 93 5
5 5 93 1 113 96 96 96 96 96 96 96 96 96 96 115 4 102 103 104 1 90 90 93 94 93 93 101 93 4 1 2 2 5 5 1 93 4 93 5
5 5 94 2 113 91 91 91 91 91 91 91 91 91 91 115 3 118 119 120 5 2 2 94 93 93 94 4 93 105 106 107 1 1 3 1 3 93 1 90
5 5 93 2 129 130 130 130 130 130 130 130 130 130 130 131 4 134 135 136 93 93 93 1 2 92 93 94 93 121 122 123 2 2 17 18 18 18 19 5
5 5 1 1 4 94 1 2 2 94 2 94 94 94 94 93 3 2 4 1 4 4 2 3 4 2 94 3 133 137 138 139 4 1 25 20 21 36 27 5
5 5 94 1 1 1 17 18 18 18 18 18 18 19 93 93 4 2 5 5 5 1 2 2 2 2 4 93 94 94 94 94 2 3 25 28 29 36 27 5
5 5 1 94 1 93 25 36 26 26 36 26 36 27 2 93 4 1 5 5 5 4 2 2 92 92 1 94 94 94 94 3 2 1 33 34 34 34 35 5
5 2 133 133 94 1 33 34 34 34 34 34 34 35 2 1 4 3 5 5 5 1 4 1 1 2 1 101 101 101 94 89 3 2 3 3 5 5 2 5
5 1 3 3 4 94 1 1 1 1 1 94 2 93 93 94 2 2 2 1 4 2 4 4 4 3 2 94 3 3 93 93 97 98 98 98 98 98 98 99
5 101 2 2 97 98 98 98 98 98 98 98 98 98 98 99 1 3 2 3 2 90 1 4 92 2 3 93 1 1 5 94 113 96 96 96 96 96 96 115
5 101 1 1 113 91 91 91 91 91 91 91 91 91 91 115 4 102 103 104 1 1 2 3 92 92 4 2 4 1 5 3 113 91 91 91 91 91 91 115
5 101 1 1 113 96 96 96 96 96 96 96 96 96 96 115 4 118 119 120 5 4 2 4 4 4 3 108 109 3 5 1 113 96 96 96 96 96 96 115
5 3 4 2 129 130 130 130 130 130 130 130 130 130 130 131 2 134 135 136 2 1 3 2 2 2 2 124 125 4 5 2 113 91 91 91 91 91 91 115
5 3 1 2 3 4 1 1 4 2 3 3 4 2 2 2 3 1 3 1 97 99 3 4 2 2 2 2 94 1 5 3 113 96 96 96 96 96 96 115
5 108 109 1 108 109 1 108 109 4 108 109 1 108 109 2 108 109 4 3 113 116 5 5 5 2 4 108 109 2 5 3 113 91 91 91 91 91 91 115
5 124 125 4 124 125 1 124 125 1 124 125 4 124 125 1 124 125 2 1 113 4 5 5 5 2 2 124 125 3 5 1 113 96 96 96 96 96 96 115
5 2 2 4 3 2 1 2 2 2 1 4 4 2 2 1 2 4 3 3 113 2 3 2 3 2 4 2 4 2 1 1 113 91 91 91 91 91 91 115
5 89 3 4 89 2 2 89 3 2 89 4 3 89 1 1 89 3 4 1 129 132 102 103 104 2 3 102 103 104 1 1 113 96 96 96 96 96 96 115
5 4 2 2 105 106 107 3 4 4 105 106 107 3 4 1 105 106 107 1 4 3 118 119 120 1 3 118 119 120 2 4 113 91 91 91 91 91 91 115
5 3 1 1 121 122 123 3 1 2 121 122 123 2 4 3 121 122 123 1 2 4 134 135 136 1 2 134 135 136 2 93 113 96 96 96 96 96 96 115
5 3 1 133 137 138 139 2 4 133 137 138 139 1 4 133 137 138 139 1 1 90 102 103 104 4 1 102 103 104 1 4 113 91 91 91 91 91 91 115
5 4 2 3 4 4 4 4 2 4 3 2 4 3 4 1 3 3 4 4 1 90 118 119 120 3 2 118 119 120 4 4 129 130 130 130 130 130 130 131
5 5 5 5 5 5 5 5 5 5 5 5 5 5 5 5 5 114 132 1 114 132 134 135 136 5 5 134 135 136 5 5 133 133 1 5 5 5 5 5
