20 34 34 34 34 34 34 34 34 34 34 34 34 34 34 34 34 34 34 34 34 34 34 34 34 34 34 34 34 34 34 34 34 34 34 34 34 34 34 21
27 9 1 11 13 3 10 10 13 12 5 2 3 4 2 2 4 2 12 10 11 3 10 10 10 3 1 3 1 12 5 3 2 12 5 9 10 3 9 25
27 1 5 4 1 4 4 11 2 4 11 4 12 11 1 13 13 3 3 2 10 13 5 4 11 13 11 2 9 3 4 3 9 10 13 12 3 13 3 25
27 12 13 9 11 10 9 5 12 11 3 11 5 2 1 9 13 10 5 11 5 12 2 5 5 5 12 9 3 13 12 5 12 1 12 4 9 10 1 25
27 11 9 10 10 11 11 13 12 10 9 9 1 2 9 2 10 11 10 13 10 1 3 1 13 9 10 5 13 1 4 1 3 9 12 4 10 4 13 25
27 9 12 9 13 5 4 12 2 5 10 13 10 10 9 1 13 12 5 4 12 5 10 5 11 12 11 11 4 11 3 1 9 5 5 12 1 5 3 25
27 11 9 12 5 2 4 3 1 1 2 5 2 1 9 13 3 2 2 10 3 13 12 2 5 12 5 13 2 3 3 2 3 2 12 3 4 11 9 25
27 3 12 4 5 9 1 13 9 5 3 2 3 2 2 10 11 10 4 9 12 2 3 5 10 4 10 5 3 2 10 10 13 9 3 1 9 13 9 25
27 5 2 9 13 12 4 13 13 3 10 2 5 9 5 5 11 2 1 9 13 3 2 11 10 2 13 5 12 9 12 12 13 3 11 5 13 1 12 25
27 9 11 10 11 5 12 12 2 1 13 13 11 13 11 11 5 5 11 1 5 11 11 13 1 5 1 5 13 2 2 12 12 3 9 4 2 9 1 25
27 5 4 3 13 12 12 13 9 13 13 11 2 13 2 2 2 13 13 11 5 11 11 5 1 13 1 5 5 9 3 13 13 5 3 2 9 3 2 25
27 9 12 3 11 3 12 13 13 10 5 11 2 5 2 2 2 9 9 9 9 9 9 9 9 1 1 1 5 12 1 12 9 13 9 10 4 3 3 25
27 3 11 10 13 1 11 13 11 13 11 13 2 13 13 9 9 9 13 9 9 9 13 13 9 1 1 1 13 2 10 3 10 4 1 11 3 11 10 25
27 1 4 5 11 5 10 13 13 10 10 10 2 11 13 13 9 9 9 9 13 9 13 13 9 11 10 13 1 9 12 4 12 12 5 10 2 5 1 25
27 3 12 1 12 12 13 1 3 10 11 11 10 10 10 5 9 3 11 1 9 12 13 3 11 11 10 13 13 9 13 3 13 2 10 9 1 2 11 25
27 4 2 1 11 13 10 2 13 10 11 11 10 11 10 4 11 3 9 11 5 10 13 9 10 10 11 13 1 3 5 1 3 3 1 1 2 9 12 25
27 5 4 5 10 12 13 9 13 11 13 13 13 13 12 11 13 2 11 10 1 9 13 10 11 11 13 1 13 10 10 12 9 1 1 4 11 11 3 25
27 5 10 9 13 2 13 1 1 11 11 11 11 11 4 1 10 10 10 5 1 12 11 13 10 11 13 3 1 5 1 13 12 11 2 10 13 11 5 25
27 12 13 10 5 11 13 10 13 11 10 11 10 10 4 2 10 86 10 13 13 3 10 9 10 10 10 13 13 2 13 10 13 9 9 5 4 11 10 25
27 5 5 3 10 5 13 13 10 11 11 13 11 10 10 5 13 5 9 5 4 5 12 2 10 11 10 1 13 3 12 1 1 2 12 3 12 5 4 25
27 9 11 4 13 4 5 12 10 10 11 10 11 11 9 11 2 11 10 3 10 9 3 2 11 11 10 13 1 12 1 2 3 11 13 9 9 13 1 25
27 13 4 2 5 12 4 13 10 11 10 13 10 11 5 10 3 3 10 10 3 12 10 4 13 10 11 13 1 12 11 9 2 1 13 4 11 4 11 25
27 9 4 11 3 5 9 10 13 10 10 11 11 10 11 11 10 4 10 1 10 13 1 9 10 11 10 1 13 5 1 9 9 11 9 5 2 5 11 25
27 1 4 1 2 5 5 1 13 10 10 11 10 10 5 11 3 3 1 4 10 3 1 11 11 11 10 13 1 4 4 13 11 11 11 2 2 3 12 25
27 10 3 12 3 10 9 11 13 10 11 13 11 10 4 5 11 5 11 11 13 1 10 3 10 11 11 13 1 12 11 12 2 3 10 5 4 13 1 25
27 13 5 2 3 11 1 5 13 10 11 10 10 11 10 11 10 13 11 11 11 10 11 10 11 11 11 1 13 10 10 12 1 5 1 3 1 5 12 25
27 3 5 2 11 5 10 2 13 10 11 11 11 11 10 10 10 10 10 11 11 10 10 10 13 11 11 13 1 5 4 3 10 10 13 1 3 5 3 25
27 5 1 9 5 1 10 1 13 13 13 2 2 11 10 10 10 11 11 11 11 10 10 11 11 13 11 13 1 3 9 1 9 10 4 10 11 4 9 25
27 11 2 12 12 10 1 3 2 2 13 2 2 13 3 3 11 3 3 11 13 11 11 13 13 10 13 1 13 3 1 4 5 4 3 2 3 4 3 25
27 5 9 12 13 13 4 10 13 2 13 2 13 11 13 3 13 13 13 3 13 13 11 13 1 1 1 13 1 1 12 11 1 1 3 13 10 4 2 25
27 13 13 1 3 2 2 1 9 2 13 11 13 4 3 13 11 2 1 13 13 9 13 5 10 10 13 2 11 12 9 12 13 3 3 1 11 5 10 25
27 11 2 5 1 10 9 4 10 9 3 13 11 11 10 9 9 11 13 10 2 4 11 2 5 13 11 13 1 11 5 2 9 4 11 4 13 10 12 25
27 4 12 3 10 1 5 1 12 13 2 12 10 4 1 9 2 10 5 2 10 12 2 1 10 2 4 9 11 3 2 1 10 3 11 11 1 12 5 25
27 2 10 4 3 13 9 1 5 2 4 5 1 13 4 9 9 2 2 3 1 3 2 3 13 13 2 4 13 3 1 11 5 1 2 10 5 9 10 25
27 4 4 1 12 5 1 3 3 3 12 13 10 5 10 1 4 1 11 12 9 10 11 12 3 13 10 3 1 13 10 5 4 11 2 3 2 11 3 25
27 10 13 9 11 2 9 9 9 10 12 12 13 9 9 12 5 3 12 4 12 10 5 9 2 2 11 12 1 9 2 2 4 2 11 11 3 5 1 25
27 11 9 3 9 13 3 4 12 13 11 11 10 11 11 12 2 11 3 10 9 12 10 10 9 9 10 2 2 13 2 10 4 13 4 11 2 1 4 25
27 10 2 9 5 13 11 2 3 11 13 1 2 1 13 5 3 9 2 9 5 9 13 5 9 1 11 1 3 10 4 3 1 10 9 3 10 9 11 25
27 12 12 12 12 2 10 5 5 3 5 3 4 2 12 13 13 10 9 5 4 5 4 13 4 3 1 13 11 9 11 5 11 4 3 10 10 11 9 25
28 18 18 18 18 18 18 18 18 18 18 18 18 18 18 18 18 18 18 18 18 18 18 18 18 18 18 18 18 18 18 18 18 18 18 18 18 18 18 29
