20 34 34 34 34 34 34 34 34 34 34 34 34 34 34 34 34 34 34 34 34 34 34 34 34 34 34 34 34 34 34 34 34 34 34 34 34 34 34 21
27 12 13 1 2 13 12 11 12 10 12 9 1 12 13 9 3 3 4 13 3 13 11 11 9 2 4 13 4 12 2 4 11 4 1 3 9 11 10 25
27 9 10 9 3 11 1 2 12 1 13 2 1 1 11 10 12 10 13 11 12 5 10 13 4 3 10 1 12 4 13 12 12 1 1 3 9 11 13 25
27 9 13 10 12 9 2 13 10 12 10 2 13 1 10 13 11 13 11 5 9 12 2 4 4 13 9 3 5 1 11 37 37 13 12 9 5 4 9 25
27 13 12 10 3 2 10 9 3 1 2 1 4 4 11 4 12 1 12 10 5 1 17 18 18 18 18 18 18 18 18 18 18 19 13 3 9 12 3 25
27 2 13 11 5 12 1 4 2 11 4 5 1 13 37 37 11 13 13 10 3 1 25 20 34 34 34 34 34 34 34 34 21 27 13 5 3 11 2 25
27 4 11 11 3 4 4 37 9 13 11 5 5 12 37 37 13 5 2 1 10 4 25 27 10 2 10 2 11 13 13 2 25 27 3 5 4 11 13 25
27 2 9 3 13 2 13 3 10 9 11 3 5 2 3 11 1 12 12 11 3 5 25 27 1 11 12 12 2 13 11 12 25 27 3 1 5 10 1 25
27 12 1 11 12 5 1 9 10 12 10 12 10 3 3 11 3 9 3 2 13 13 25 27 12 13 3 12 4 13 12 12 25 27 5 5 10 13 2 25
27 4 3 1 12 5 12 10 5 13 11 9 4 13 11 11 2 2 3 1 5 9 25 27 37 3 3 2 10 5 1 9 33 35 11 5 2 3 1 25
27 5 13 4 2 17 18 18 18 18 18 18 18 18 19 1 17 18 18 18 18 18 29 27 12 9 9 1 5 10 11 10 1 1 1 4 2 11 2 25
27 1 10 9 4 25 36 36 26 36 36 26 26 26 27 1 25 36 36 26 26 36 26 28 18 18 18 18 18 19 11 11 17 19 10 2 10 11 2 25
27 1 10 5 13 25 36 36 26 36 26 26 26 26 27 1 25 26 36 36 26 36 26 36 36 26 36 36 26 27 11 11 25 27 5 9 3 9 12 25
27 2 9 12 10 25 36 36 20 34 34 34 34 34 35 1 33 34 34 34 34 34 34 34 34 34 34 34 34 35 11 2 25 27 2 13 9 5 10 25
27 4 11 3 13 25 36 26 27 5 10 1 12 3 13 2 9 37 37 9 9 4 3 12 9 4 5 5 9 11 9 13 25 27 2 10 9 1 4 25
27 9 10 4 3 25 26 26 27 9 3 13 11 5 11 2 5 37 37 13 3 13 9 2 12 3 11 1 12 4 5 37 25 27 5 10 10 3 13 25
27 12 9 11 9 25 36 36 27 10 5 12 4 12 3 13 9 4 5 11 2 9 2 13 13 9 2 13 13 11 5 11 25 27 13 13 3 12 12 25
27 5 3 5 12 25 26 26 27 1 11 2 4 10 12 11 5 1 12 1 5 12 11 10 11 5 9 9 12 13 1 13 25 27 5 10 2 11 1 25
27 10 11 12 9 25 36 26 27 37 3 2 9 5 12 9 3 11 4 4 10 37 9 1 12 10 3 12 9 3 5 4 25 27 5 11 3 3 11 25
27 10 1 12 3 25 26 26 27 3 12 10 11 3 3 9 13 13 2 2 1 37 1 10 5 9 10 5 3 13 2 3 33 35 10 13 5 9 5 25
27 2 9 5 12 25 36 36 27 5 3 2 11 9 5 3 9 13 4 10 4 3 3 9 2 4 13 13 10 13 13 4 3 2 12 1 10 9 5 25
27 13 12 10 10 25 26 26 27 11 13 3 4 1 13 4 5 2 10 13 10 11 5 10 4 3 1 1 13 3 5 13 1 10 9 12 11 11 3 25
27 5 9 1 4 25 36 26 28 18 18 18 18 18 18 18 18 18 18 18 18 18 18 19 13 2 11 12 13 5 4 9 3 10 11 12 3 10 13 25
27 5 12 2 11 33 34 34 34 34 34 34 34 34 21 26 36 20 34 34 34 34 34 35 10 1 11 12 13 9 12 9 5 3 12 9 2 9 10 25
27 1 2 4 10 13 12 1 9 10 10 4 1 9 25 36 36 27 1 2 2 13 1 10 5 10 3 11 10 11 12 37 12 9 2 9 3 12 11 25
27 10 13 4 12 13 9 10 3 2 37 9 11 37 25 26 26 27 12 9 13 5 1 13 13 5 4 5 11 11 9 9 3 37 2 13 2 5 9 25
27 9 12 4 3 1 13 5 11 13 2 11 11 5 25 36 26 27 3 3 13 11 9 12 13 3 10 2 12 9 10 13 10 2 4 5 5 1 5 25
27 2 2 4 10 5 9 12 5 12 3 10 12 3 25 26 36 27 3 4 3 1 12 11 13 12 3 4 12 10 3 10 13 12 2 11 12 12 2 25
27 12 12 2 13 10 1 2 2 2 9 13 10 12 25 26 36 27 9 9 13 13 9 10 3 1 9 5 2 1 10 4 12 9 2 9 4 3 11 25
27 1 2 9 1 9 37 5 5 12 9 1 4 11 25 26 26 27 13 9 9 10 11 9 10 12 4 13 37 1 4 3 1 2 5 2 1 10 13 25
27 2 11 9 13 10 10 5 10 10 13 3 9 2 33 34 34 35 13 13 11 13 5 3 13 13 1 3 37 10 5 10 9 12 4 5 9 11 4 25
27 3 1 4 10 12 12 1 11 11 11 11 2 4 4 13 4 12 3 4 11 13 1 13 10 10 2 13 4 5 4 2 13 10 1 1 11 2 10 25
27 4 2 2 12 9 12 12 1 2 3 3 12 37 5 3 10 9 4 13 13 5 5 12 5 11 10 4 11 11 10 2 5 11 9 11 12 10 4 25
27 12 3 10 4 3 5 13 13 2 11 11 3 13 11 3 10 1 4 11 11 13 10 5 5 13 37 13 9 10 11 13 9 2 5 10 11 11 13 25
27 4 3 13 1 13 12 10 3 11 3 3 3 4 5 1 9 10 2 12 4 9 10 10 3 11 12 10 1 13 11 12 12 13 13 13 5 4 2 25
27 2 10 4 5 9 11 13 4 12 11 11 11 12 12 5 11 9 2 11 3 5 13 1 5 12 3 5 10 9 9 1 2 10 11 9 10 11 12 25
27 2 11 9 13 3 9 9 9 4 3 3 1 1 2 5 2 12 2 11 11 3 3 1 9 9 1 10 2 1 12 13 11 10 3 10 5 2 9 25
27 13 3 5 1 3 2 1 11 9 9 3 13 4 2 3 10 5 13 10 3 9 4 10 5 12 3 2 10 11 5 9 3 13 11 2 4 12 5 25
27 13 11 1 11 9 5 10 11 9 3 10 5 4 12 11 2 2 12 11 13 1 13 3 11 10 4 9 13 9 12 3 5 10 4 86 1 11 3 25
28 18 18 18 18 18 18 18 18 18 18 18 18 18 18 18 18 18 18 18 18 18 18 18 18 18 18 18 18 18 18 18 18 18 18 18 18 18 18 29
