20 34 34 34 34 34 34 34 34 34 34 34 34 34 34 34 34 34 34 34 34 34 34 34 34 34 34 34 34 34 34 34 34 34 34 34 34 34 34 21
27 2 3 2 2 2 1 37 2 1 1 1 2 2 13 2 2 2 5 1 2 1 12 2 2 1 13 4 3 4 12 4 13 13 13 4 5 13 86 25
27 2 13 3 4 5 3 3 2 2 3 1 5 1 2 1 1 1 2 2 12 2 2 12 5 1 5 13 13 13 2 11 11 9 10 9 5 13 4 25
27 2 1 2 13 13 1 1 3 2 13 2 1 2 2 1 2 2 1 2 1 5 2 1 1 2 2 9 11 5 11 11 11 11 2 12 12 4 12 25
27 3 2 1 1 1 13 3 3 3 2 17 18 18 18 18 19 1 1 1 1 17 18 18 18 19 4 13 11 12 4 3 5 10 3 13 12 13 12 25
27 3 4 2 2 3 1 3 5 1 3 25 36 36 26 26 27 2 13 1 1 25 36 26 26 27 37 3 10 3 12 1 2 4 13 5 10 13 13 25
27 1 3 5 3 3 3 3 2 2 2 25 26 26 26 26 27 1 1 1 1 25 36 36 26 27 3 5 9 9 1 5 11 11 11 1 9 10 10 25
28 18 18 18 18 18 18 18 18 18 18 29 36 26 36 36 27 1 1 1 1 25 36 36 36 27 10 10 4 5 2 5 13 12 10 13 13 10 10 25
26 36 26 26 36 26 26 36 36 36 26 26 36 26 36 26 27 1 1 1 1 25 36 36 26 27 10 1 4 10 10 3 2 12 12 13 1 12 10 25
26 26 26 36 26 36 26 26 36 26 26 26 36 26 26 26 27 1 1 1 1 25 26 26 36 27 10 12 9 12 10 3 5 2 11 12 12 11 13 25
26 36 26 26 26 26 36 36 36 36 26 26 36 36 26 36 27 1 13 1 1 25 26 36 26 27 9 4 3 13 5 12 9 4 1 9 9 11 10 25
26 36 36 26 36 36 26 26 36 36 26 26 36 26 26 36 27 1 1 1 1 25 36 26 26 27 2 13 9 10 2 9 5 10 4 1 2 9 10 25
20 34 34 34 34 34 34 34 34 34 34 34 34 34 34 34 35 1 1 13 2 25 26 36 36 27 11 9 4 5 10 5 37 5 1 12 10 12 10 25
27 37 2 1 11 10 11 13 3 13 10 3 2 3 3 11 11 1 13 4 4 25 36 36 26 27 11 13 9 10 11 9 37 9 5 2 5 11 10 25
27 11 10 3 13 3 3 2 11 10 2 3 10 10 4 9 2 4 5 10 4 25 36 26 36 27 2 2 13 3 10 11 11 4 5 9 3 4 10 25
27 1 3 5 13 3 3 11 2 11 11 3 2 10 2 1 10 11 11 9 5 25 26 36 36 27 4 13 12 4 5 13 13 10 3 13 9 13 10 25
27 10 3 2 11 1 3 2 3 10 11 13 3 11 4 9 12 11 9 12 4 25 26 36 36 27 3 10 12 13 12 12 3 10 2 2 3 13 10 25
27 12 13 2 13 9 10 10 37 10 10 2 2 2 5 4 12 9 11 4 3 33 34 34 34 35 2 1 9 9 9 13 5 4 3 2 5 4 10 25
27 3 9 10 4 12 2 13 3 11 11 2 10 10 3 4 2 2 10 4 11 13 12 11 4 2 9 12 9 5 9 10 1 13 11 3 12 5 10 25
27 4 4 2 10 4 13 11 2 13 13 11 3 13 10 10 13 12 10 4 5 10 4 12 11 10 11 9 1 12 2 5 13 5 10 2 4 13 10 25
27 9 1 4 4 1 13 10 2 11 11 10 10 13 13 10 12 4 1 10 10 2 13 3 10 13 2 1 11 10 13 3 1 5 1 4 10 4 10 25
27 1 3 9 1 9 10 3 13 3 2 2 11 2 9 5 11 11 11 5 5 4 5 1 12 10 5 9 2 2 4 5 2 3 4 9 13 4 10 25
27 9 9 2 9 1 10 2 10 2 2 2 11 11 11 1 3 5 2 2 10 17 18 18 18 19 3 13 12 4 10 9 11 11 11 9 12 12 10 25
27 3 10 10 12 2 3 10 3 10 13 3 2 11 5 4 4 5 2 2 10 25 36 36 36 27 3 4 4 11 2 5 2 10 4 13 3 12 10 25
27 3 12 9 12 2 13 11 3 3 11 2 11 13 12 13 9 1 11 11 13 25 26 26 36 27 12 9 4 11 3 11 5 3 2 2 3 10 10 25
27 11 5 9 12 13 13 11 10 2 2 13 10 10 12 2 12 3 9 13 9 25 26 26 36 27 2 5 1 13 3 11 5 11 4 5 10 10 10 25
27 2 1 13 17 18 18 18 18 18 18 18 18 18 18 18 18 18 18 18 18 29 36 26 26 27 4 4 9 13 4 3 10 10 3 12 5 3 10 25
27 3 4 1 25 26 36 26 26 26 26 26 36 36 26 36 26 26 26 26 26 36 36 26 26 27 2 2 13 4 3 12 1 12 5 12 5 3 10 25
27 3 5 4 25 26 36 36 26 36 36 36 36 36 26 26 36 20 34 34 34 34 34 34 34 35 4 3 9 9 2 11 10 5 13 12 5 3 10 25
27 3 3 4 25 36 26 26 26 26 26 26 36 26 26 26 36 27 12 12 13 4 11 5 11 5 1 11 1 2 1 3 11 3 13 9 13 3 10 25
27 10 11 10 25 26 36 26 26 36 26 26 36 26 36 36 36 27 13 12 4 11 12 11 11 11 4 12 4 12 10 9 3 3 1 9 1 2 10 25
27 11 13 5 25 36 26 36 36 26 36 26 36 36 26 26 36 27 5 13 12 11 4 11 11 11 11 3 13 2 5 3 13 3 3 1 10 10 10 25
27 1 11 10 25 36 36 36 26 26 26 36 26 26 26 26 36 27 2 1 4 11 13 4 4 5 2 1 1 4 1 5 13 2 3 4 3 10 10 25
27 9 10 12 25 36 26 26 26 36 26 26 36 26 26 36 36 27 3 2 4 5 37 13 4 4 12 1 12 4 4 12 10 10 1 11 1 4 13 25
27 11 3 5 33 34 34 34 34 34 34 34 34 34 34 34 34 35 1 1 4 12 37 11 4 12 4 10 1 3 13 2 4 2 5 9 9 9 10 25
27 4 37 10 10 4 11 10 2 13 11 13 11 4 1 9 10 4 1 2 3 13 12 13 12 11 13 5 11 1 10 1 9 9 2 2 1 11 10 25
27 4 12 13 13 11 5 9 1 2 3 11 9 3 9 12 11 11 1 2 11 10 12 3 2 9 4 12 2 2 12 13 13 5 3 9 3 4 10 25
27 2 1 9 3 13 10 10 9 1 12 4 5 2 5 10 13 13 1 3 9 11 1 5 2 2 13 12 3 4 13 5 3 2 2 3 1 1 10 25
27 5 5 11 4 12 9 2 9 1 13 3 13 11 11 4 10 9 3 2 11 2 12 12 11 12 3 13 12 11 1 12 12 1 3 11 9 2 10 25
28 18 18 18 18 18 18 18 18 18 18 18 18 18 18 18 18 18 18 18 18 18 18 18 18 18 18 18 18 18 18 18 18 18 18 18 18 18 18 29
