97 98 98 98 98 98 98 98 98 98 98 98 98 98 98 98 99 5 86 71 71 86 5 97 98 98 98 98 98 98 98 98 98 98 98 98 98 98 98 99
113 102 103 104 93 93 92 94 94 94 94 93 94 5 94 5 115 5 32 72 72 30 5 113 5 94 93 4 93 4 4 1 5 4 94 5 5 5 5 115
113 118 119 120 108 109 93 93 92 92 108 109 3 3 5 5 115 5 32 31 31 30 4 113 94 94 2 3 4 5 4 1 5 94 4 5 108 109 94 116
3 134 135 136 124 125 93 92 94 93 124 125 5 3 94 94 115 1 32 31 72 30 5 113 93 92 94 4 4 93 5 5 2 1 2 94 124 125 94 101
101 93 94 89 93 94 93 94 94 93 94 94 94 5 5 5 115 2 32 31 31 30 5 113 3 4 1 3 5 1 5 93 94 5 94 93 94 94 94 3
1 93 92 94 94 93 93 93 94 93 93 93 5 5 3 3 115 3 32 31 31 30 5 113 133 94 5 3 4 4 3 94 3 5 5 4 1 5 3 92
113 108 109 93 93 93 94 93 94 94 93 93 93 93 94 94 6 39 40 31 31 38 39 7 93 93 2 5 94 3 2 93 5 94 3 2 3 94 93 101
113 124 125 93 94 94 93 105 106 107 94 94 93 93 94 93 32 31 31 31 31 31 31 30 94 93 94 93 93 93 105 106 107 94 94 94 93 93 93 100
113 93 93 93 94 94 94 121 122 123 93 93 93 93 94 93 14 23 24 31 31 22 23 15 94 94 93 5 93 94 121 122 123 93 93 94 93 93 94 115
113 94 93 94 94 93 93 137 138 139 94 94 94 94 93 93 1 1 32 31 31 30 3 3 94 93 94 94 94 94 137 138 139 94 94 93 94 93 93 115
113 93 2 91 94 5 93 94 90 90 5 93 94 94 90 90 115 89 32 31 31 30 89 113 133 91 1 2 91 2 95 91 3 3 3 3 1 92 1 115
113 5 2 91 5 2 91 94 91 93 2 91 90 5 94 93 115 2 32 31 31 30 2 113 93 94 91 94 1 3 3 1 95 94 3 92 95 95 3 115
113 5 91 5 2 1 93 2 93 94 94 91 94 94 94 90 115 1 32 31 31 30 2 113 93 1 1 95 94 92 91 2 95 3 2 92 1 2 92 115
113 2 2 94 1 2 94 1 93 5 1 93 94 2 90 94 115 3 32 31 31 30 4 113 94 95 94 95 92 2 94 1 2 3 2 91 94 91 2 115
113 5 94 91 94 1 90 93 2 90 1 90 90 91 1 5 115 5 32 31 31 30 5 113 93 3 92 1 3 95 2 2 3 1 94 2 92 1 94 115
113 5 1 1 94 5 5 2 90 91 91 1 94 91 94 94 115 5 32 31 31 30 3 113 93 2 94 3 3 94 92 3 1 2 92 1 92 1 95 115
129 130 130 130 130 130 6 39 39 7 130 130 130 130 130 130 131 4 32 31 31 30 2 129 130 130 130 130 130 130 6 39 39 7 130 130 130 130 130 131
5 5 1 5 1 2 32 31 31 30 5 3 5 2 5 4 1 1 32 31 31 30 2 5 4 3 3 3 5 5 32 31 31 30 2 1 5 4 3 5
101 39 39 39 39 39 40 31 31 38 39 39 39 39 39 39 39 39 40 31 31 38 39 39 39 39 39 39 39 39 40 31 31 38 39 39 39 39 39 101
71 72 31 31 31 31 31 31 31 31 31 31 31 31 31 31 31 31 31 31 31 31 31 31 31 31 31 31 31 31 31 31 31 31 31 31 31 31 72 71
71 72 31 31 31 31 31 31 31 31 31 31 31 31 31 31 31 31 31 72 31 31 31 31 31 31 31 31 31 31 31 31 31 31 31 72 31 31 31 71
101 23 23 23 23 23 24 31 31 22 23 23 23 23 23 23 23 23 24 31 31 22 23 23 23 23 23 23 23 23 24 31 31 22 23 23 23 23 23 101
5 5 4 3 5 2 32 31 31 30 2 3 5 2 5 5 2 3 32 31 31 30 3 5 3 1 5 3 1 3 32 31 31 30 1 5 4 5 2 5
97 98 98 98 98 98 14 23 23 15 98 98 98 98 98 98 99 2 32 31 31 30 1 97 98 98 98 98 98 98 14 23 23 15 98 98 98 98 98 99
113 133 94 93 95 9 9 93 3 4 10 91 5 5 3 1 115 1 32 31 31 30 3 113 9 94 2 91 10 5 93 94 93 94 5 2 93 93 2 115
113 1 9 10 1 91 10 93 95 93 9 1 94 1 93 10 115 5 32 31 31 30 1 113 91 95 2 91 9 3 5 94 4 1 10 3 2 3 3 115
113 4 5 1 4 94 2 91 95 4 94 5 9 1 4 2 115 3 32 31 31 30 5 113 91 94 94 5 1 2 10 5 5 93 4 3 91 9 5 115
113 3 4 3 9 9 94 94 3 9 5 1 94 91 5 4 115 1 32 31 31 30 2 113 2 91 91 5 10 3 3 10 95 91 9 9 9 9 10 115
113 3 10 94 95 95 2 3 10 93 93 5 2 91 5 2 115 3 32 31 31 30 5 113 9 94 1 2 91 10 95 3 2 95 95 10 3 94 95 115
113 5 93 2 91 10 10 93 3 91 95 5 94 5 9 93 115 3 32 31 31 30 1 113 10 94 95 95 10 4 10 10 94 94 94 94 91 4 95 115
113 94 2 4 2 91 91 95 3 1 4 95 2 5 95 9 1 13 32 31 31 30 2 3 4 2 2 1 94 93 1 1 2 10 91 93 91 5 94 115
113 94 5 3 3 2 10 2 5 10 91 10 94 1 2 91 6 39 40 31 31 38 39 7 5 9 2 2 9 9 93 1 2 3 5 93 4 9 4 115
113 1 2 10 95 3 91 91 93 4 5 93 3 91 93 93 32 31 31 31 31 31 31 30 93 91 93 10 1 9 93 95 4 95 4 5 93 1 3 115
113 1 5 9 2 5 91 2 95 4 94 91 93 4 93 94 14 23 24 31 31 22 23 15 5 10 5 4 95 2 9 9 5 10 94 102 103 104 3 115
89 2 2 3 94 4 95 10 93 94 93 93 93 94 95 3 115 1 32 31 31 30 13 113 95 94 94 94 10 5 91 91 10 95 93 118 119 120 94 3
94 101 2 3 94 94 94 93 94 94 2 10 93 91 94 91 115 2 32 31 31 30 5 113 9 1 1 9 95 1 3 4 4 2 2 134 135 136 93 2
89 2 3 2 105 106 107 93 94 94 105 106 107 93 93 93 115 2 32 31 31 30 2 113 93 93 93 105 106 107 94 94 94 105 106 107 94 89 4 133
113 94 94 93 121 122 123 93 93 93 121 122 123 94 93 94 115 5 32 31 31 30 5 113 93 93 93 121 122 123 93 93 93 121 122 123 93 94 93 115
113 133 93 93 137 138 139 93 94 93 137 138 139 94 93 93 115 5 32 72 72 30 5 113 93 93 93 137 138 139 93 94 94 137 138 139 93 93 133 115
129 130 130 130 2 2 2 130 130 130 2 2 2 130 130 130 131 5 86 71 71 86 5 129 130 130 130 130 130 130 130 130 130 130 130 130 130 130 130 131
